----------------------------------------------------------------------------------------------------------------------------------------------------------------------------------------------------------------------------------------------------------------
----------------------------------------------------------------------------------------------------------------------------------------------------------------------------------------pP----------------------------------------------------------------------
----------------------------------------------------------------------------------------------------------------------------------------------------------------------------------------pP----------------------------------------------------------------------
-----------------------------------------------------------------------------------------------------------------------------------------------------------------------B-----------?----##-----------------------------------------------------------e##--------
-----------------------------------------------------------------------------------------------------------------------B----------------------------------------------------------------------------------------------------------------------------e###--------
--------------------------------------------------------------------------------------------------------------------------------------------------------------------------------------------------------------------------------------e------------e####--------
------------------------------------------------------------------------------------------------------------------------------------------------------------------------------------?--------------------------------------------------###------#--#####--------
----------e---------------------------------------------------------------------##-------------------------------------------------------------------------------------B--------------------------------------------------------------------------######--------
-------------pP----------------------------------pP----------------e---e--------###-------------------------e------------------------------------------------------pP---------------------------------------#------------------------------------#######--------
-------------pP-----------------------------#----pP-----------------------------####-----------------------------------#-------------------------------------------pP---#----pP-----------------#-----------#------pP---------------------------########--------
-------------pP---e---e--------eee----------##---pP------ee----------------#----#####-----pP-----##---ee-----------#---#-------e--eee-----ee-------------eee-------pP-e-#----pP--e--------------#----ee-----#------pP-----e----ee--------------#########--------
####################pP####pP###########-----###--pP#########################----######----pP------##################---#--###############################################----#########----------#####################--###############--------##################
