-------------------------------------------------------------------------------------------------------------------------------------------------------------------------------
-------------------------------------------------------------------------------------------------------------------------------------------------------------------------------
-------------------------------------------------------------------------------------------------------------------------------------------------------------------------------
-------------BBBBBBBBBBB------------???????---------BBB?BBB?BBBB----BBBBBBBBBBBB#--------------------------------------?------------------------------------------------##-----
--------------------------------------------------------------------------------#--------------------------------------------------------------------------------------###-----
--------------------------------------------------------------------------------#-------------------------------------------------------------------------------------####-----
--------------------------------------------------------------------------------#----------------------------------------pP------------------------------------------#####-----
-------------BBBBBBBBBBB-----????---B---------------------pP------B------------?#-pP--------------------???--------------pP-------pP--pP----------------------------######-----
----------------------------------------------------------pP--------------------#-pP------------------------------------?pP---pP--pP--pP---------------------------#######-----
----------------------------------------------------------pP---------------pP---#-pP-------------------------------------pP---pP--pP--pP--------------------------########-----
----------------------------------------------------------pP---------------pP---#-pP-------------------------------------pP---pP--pP--pP-------------------------#########-----
########################----############--------#################----------##################---###########################---##--################----###----##################
########################----############--------#################----------##################---###########################---##--################----###----##################
