--------------------------------------------------------------------------------------------------------------------------------------------------------------------------------------------------------
--------------------------------------------------------------------------------------------------------------------------------------------------------------------------------------------------------
--------------------------------------------------------------------------------------------------------------------------------------------------------------------------------------------------------
------------------------------------------------------BBBBBBBBBB-------------------------------------------------------------------------------------------------------------------------------##-------
--------------------------------------------------------------------------------------------------------------------------------------------------------------------------------------------------------
--------------------------------------------------------------------------------------------------------------------------------------------------------------------------------------------------------
----------------------------------------------------------------------#----------------------------------------pP-----------------------------------------------------------------------#---#-----------
--------------------------------------------------------------BBBBBBBB#----------------------------------------pP----?????????-------------------------------------???????-----------#------------------
--------------?--------B??-------------------------------#----------------------------------------------------?pP-------------------------------------#############------------------#------------------
---------------------------------------------------------#-----------------------------------------------------pP-----------------------B------------------------------------pP------#------------------
---------------------------------------------------------#-----------------------------------------------------pP------------------------------------------------------------pP------#--------#---------
#######################################--#######--#-#######################################################################-############-############################-pPpP---#########----#####---------
#######################################--#######--#-#######################################################################-############-############################-pPpP---#########----#####---------
