----------------------------------------------------------------------------------------------------------------------------------------------------------------------------------------------------------------------------------------------------------------
----------------------------------------------------------------------------------------------------------------------------------------------------------------------------------------pP----------------------------------------------------------------------
----------------------------------------------------------------------------------------------------------------------------------------------------------------------------------------pP----------------------------------------------------------------------
-----------------------------------------------------------------------------------------------------------------------------------------------------------------------B-----------?----##-------------------------------------------------------------#--------
-----------------------------------------------------------------------------------------------------------------------B------------------------------------------------------------------------------------------------------------------------------##--------
----------------------------------------------------------------------------------------------------------------------------------------------------------------------------------------------------------------------------------------------------####--------
------------------------------------------------------------------------------------------------------------------------------------------------------------------------------------?--------------------------------------------------###------#--#####--------
--------------------------------------------------------------------------------##-------------------------------------------------------------------------------------B--------------------------------------------------------------------------######--------
-------------pP----------------------------------pP-----------------------------###--------------------------------------------------------------------------------pP---------------------------------------#------------------------------------#######--------
-------------pP-----------------------------#----pP-----------------------------####-----------------------------------#-------------------------------------------pP---#----pP-----------------#-----------#------pP---------------------------########--------
-------------pP-----------------------------##---pP------------------------#----#####-----pP-----##----------------#---#-------------------------------------------pP---#----pP-----------------#-----------#------pP--------------------------#########--------
####################pP####pP###########-----###--pP#########################----######----pP------##################---#--###############################################----#########----------#####################--###############--------##################
####################pP####pP###########-----###--pP#########################----######----pP------##################---#--###############################################----#########----------#####################--###############--------##################
