-----------------------------------------------------------------------------------------------------------------------------------------------------------------------------------------------------------------
-----------------------------------------------------------------------------------------------------------------------------------------------------------------------------------------------------------------
-----------------------------------------------------------------------------------------------------------------------------------------------------------------------------------------------------------------
-----------------##-----------------B?BBBBBBBBBBBBBBBBBBBBBBBBBBBBBBB----------------------------------------------------------------------------------------------------------------------------------##--------
----------------###------------------------------------------------------------------------------------------------------------------------------------------------------------------------------------##--------
---------------####------------------------------------------------------------------------------------------------------------------------------------------------------------------------------------##--------
---------------####----------------------------------------------------------------------------------------------------------------------------------------------------------------#----------------#--##--------
-------------#-####---????--------------------------------------------BB--------------------B?---------BB------B#?-----------------------------------pP---------------------------##----------------#--##--------
------------##-####----------------------------------------------------------------------------------------------------------------------------------pP--------------------------###--------------#-#--##--------
-----------###-####---------------------------------------------------------------------------------------------------------pP---------pP------------pP-----pP------------------####-------------##-#--##--------
----------####-####---------------------------------------------------------------------------------------------------------pP---------pP------------pP-----pP-----------------#####------------###-#--##--------
########-#####-##############-########-####-#-###-######-##############--####-#####################################################-#####-#-#------####################-#---#######################-#--##########
########-#####-##############-########-####-#-###-######-##############--####-#####################################################-#####-#-#------####################-#---#######################-#--##########