---------------------------------------------------------------------------------------------------------------------------------------------------------------------------------------
---------------------------------------------------------------------------------------------------------------------------------------------------------------------------------------
---------------------------------------------------------------------------------------------------------------------------------------------------------------------------------------
---------------------?BBB---------------------?????-----------?BBB--------BB?BB------BBBB-----------------------------?BBB-----------------------------------BBBBB---?-----------------
---------------------------------------------------------------------------------------------------------------------------------------------------------------------------------------
---------------------------------------------------------------------------------------------------------------------------------------------------------------------------------------
-----------------#---------------------------------------------------------------------------------------------------------pP----------------------------------------------------------
--------B?B-----##---?-----#-----------pP-----?????----------B-----pP---????--???---------------pP-----------------pP------pP-----------------------------?--------?--------------BB---
---------------###---------#-----------pP--------------------------pP---------------------------pP-----------------pP--pP--pP----------------------#---------------------pP------------
--------------####---------##----------pP--------------------------pP---------------------------pP----------pP-----pP--pP--pP----------------------#---------------------pP------------
-------------#####---------##----------pP--------------------------pP---------------------------pP----------pP-----pP--pP--pP----------------------#---------------------pP------------
#####################################################################################----##########---##############################---##########--####################################
#####################################################################################----##########---##############################---##########--####################################