-------------------------------------------------------------------------------------------------------------------------------------------------?--------------------------
----------------------------------------------------------------------------------------------------------------------------------------------------------------------------
----------------------------------------------------------------------------------------------------------------------------------------------------------------------------
--------------------?BB----------------------------------------------------BBBBBBB----?----------------------------------------BBBBB------------------------------##--------
--------------------------------------------------------------------------------------------------------------------------------------------------BB-------------###--------
-------------------------------------------------------------------------------------------------------------------------------------------------------#--------####--------
----------------------------------------------------------------------------------------------------------------------------------------------BB------##-------#####--------
--------------------------------????-------------------BB#?B---------------BBBBBBB---------------------------------------------BBBBB-----------------###------######--------
---------------------------------------------------------------------pP---------------pP--------------pP------------------------------#-------------####-----#######--------
---------------------------------------------------------------------pP---------------pP--------------pP----pP-----------pP-----------#------------#####----########--------
---------------------------------------------------------------------pP---------------pP--------------pP----pP-----------pP-----------#-----------######---#########--------
##################################################################--#############################################################################-##########################
##################################################################--#############################################################################-##########################