-----------------------------------------------------------------------------------------------------------------------------------------------------------------------------------------------
-----------------------------------------------------------------------------------------------------------------------------------------------------------------------------------------------
-----------------------------------------------------------------------------------------------------------------------------------------------------------------------------------------------
---------------?---------------------------------------------------------BBBBBBBB---BBB?--------------?-----------BBB----B??B--------------------------------------------------------##--------
------------------------------------------------------------------------------------------------------------------------------------------------------------------------------------###--------
-----------------------------------------------------------------------------------------------------------------------------------------------------------------------------------####--------
---------------------------------------------------------?------------------------------------------------------------------------------------------------------------------------#####--------
---------?---B?B?B---------------------pP---------pP------------------B?B--------------B-----B?----?--?--?-----B----------BB------#--#----------##--#------------BB?B------------######--------
-------------------------------pP------pP---------pP-----------------------------------------------------------------------------##--##--------###--##--------------------------#######--------
---------------------pP--------pP------pP---------pP----------------------------------------------------------------------------###--###------####--###-----pP--------------pP-########--------
---------------------pP--------pP------pP---------pP---------------------------------------------------------------------------####--####----#####--####----pP--------------pP#########--------
##############################################################--###############---################################################################--###########################################
##############################################################--###############---################################################################--###########################################
