--------------------------------------------------------------------------------------------------------------------------------------------------------------------------------------
--------------------------------------------------------------------------------------------------------------------------------------------------------------------------------------
--------------------------------------------------------------------------------------------------------------------------------------------------------------------------------------
-----------#BBBBB---------------------------------BBBBBBBBBBBBBB---BBBB-BBBBBBBBBBBBB----------------------------------BBBBBB-----------------------------------------------##--------
-----------#---------------------------------------------------------------------------------------------------------------------------------pP----------------------------###--------
-----------#---------------------------------------------------------------------------------------------------------------------------------pP---------------------------####--------
-----------#----#--------------------?--------------------------------------------------#----------------------------------------------------pP--------------------------#####--------
-----------#BBBB#---?????--------pP-----------------BBBBBBBBBBB--#B--------------???????#----------------------------pP---pP------------pP--????------------------------######--------
---------------------------------pP-----------------------------##---------------------------------------------------pP---pP------------pP-----------------------------#######--------
---------------------------------pP----------------------------###---------------------------------------------------pP---pP------------pP-------------------pP-------########--------
---------------------------------pP---------------------------####-----------#---------------------------------------pP---pP------------pP-------------------pP------#########--------
##########################pP###########pP######---####################-------##########################################---##--###################---##################################
##########################pP###########pP######---####################-------##########################################---##--###################---##################################