--------------------------------------------------------------------------------t---------------------------------------------------------------------
--------------------------------------------------------------------------------t---------------------------------------------------------------------
--------------------------------------------------------------------------------XXXXXXX-XX------------------------------------------------------------
---XXXXXXX-----------------------------------------oo---------------------------XXXXXXX-XX----------SSSSSSSSSS----------ooo---------------------------
--------------------------------------------------%%%%------------------------------------------------------------------------------------------------
----------------------ooor-------------------------||-------------------------------------------------------------------------------------------------
---------------------%%%%%-------------------------||-----------------------------------------------------------------------------!S------------------
-----XX-Xo------------|||--------------------------||--SSS--------------------------------------------------------------------------------------------
----------------------|||--------------------------||-----------------o-------------------------------------------------------------------------------
----------------------|||--------------------------||---------------------------------------------oo----------------------------XX--------------------
----------Q---------%%%%%%%------------------------||--------------------------------------------------------T-----------------XXXS------#------------
X-XXXXXXXX----------||||||------------K-T-----TT---||----------------T--------#-t--------o-----TT------TT----T-#---------------XXX------##------------
--XXXXXXXX----------||||||--o-TTTT------T-----TT--%||--------B-------T-------##-t--------------TT------TT----T-#--------------XXXX-----###---------F--
--XXXXXXXX---------#||||||-%%%TTTT------T-----TT---||--------b-------T----------t-----------y--TT---g--TT----T-#----ggg-XXXX--XXXX----####---------#--
--XXXXXXXXXXX--XXXXX||||||--|-XXXXXXXXXXXXXX--XXXX-||-------XXXXXX--XXXXXXXXXXXXt---------XXXXXXXXXXXXXXXXXXXX-XXXXXXXXXXXXX--XXXXXXXXXXXXXXXXXXXXXXXX
--XXXXXXXXXXX--XXXXX||||||--|-XXXXXXXXXXXXXX--XXXX-||-------XXXXXX--XXXXXXXXXXXXt---------XXXXXXXXXXXXXXXXXXXX-XXXXXXXXXXXXX--XXXXXXXXXXXXXXXXXXXXXXXX
