------------------------------------------------------------------------------------------------------------------------------------------------------
------------------------------------------------------------------------------------------------------------------------------------------------------
------------------------------------------------------------------------------------------------------------------------------------------------------
------------------------------------------------------------------------------------------------------------------------------------------------------
------------------------------------------------------------------------------------------------------------------------------------------------------
------------------------------------------------------------------------------------------------------------------------------------------------------
------------------------------------------------------------------------------------------------------------------------------------------------------
------------------------------------------------------------------------------------------------------------------------------------------------------
------------------------------------------------------------------------------------------------------------------------------------------------------
------------------------------------------------------------------------------------------------------------------------------------------------------
-------------------------------------------------------------------------------------------------------------tt-----------------------------tt--------
-------------------------------------------------LL----------------------------------------------------------tt-----------------------------tt--------
--------------------------------------------tt------------------------------------TT-------------------------tt-----------------------------tt------F-
-M------------------------------------------tt-------yy------------------------gg-TT-----ggg---------------kkttggg----------------------YY--ttggg---#-
XXXXXXX-----XXXXXXXXXX-----XXXXXXX-----XXXXXXXXXXXXXXXXXXX---XXXXX---XXXXXX---XXXXXXXXXXXX-----XXXXX----XXXXXXXXXXXXXXXX---XXXXXXXXXX---XXXXXXXXXXXXXX
XXXXXXX-----XXXXXXXXXX-----XXXXXXX-----XXXXXXXXXXXXXXXXXXX---XXXXX---XXXXXX---XXXXXXXXXXXX-----XXXXX----XXXXXXXXXXXXXXXX---XXXXXXXXXX---XXXXXXXXXXXXXX
