--------------------------------------------------------------------------------------------------------------------------------------------------------------------------------------------------------
--------------------------------------------------------------------------------------------------------------------------------------------------------------------------------------------------------
--------------------------------------------------------------------------------------------------------------------------------------------------------------------------------------------------------
---------------------------------------------------------------------------------b---?b------------------------?--------------------?-------------------------------------------?-----------------------
-------------------------b------------b-------------------------------------------b------------------------------------b--------------------------------------------------------------------------------
--------------------#-------------------------------------------------------------------------------------------------------------------------------------b--------------------b----------------b-------
-----------------#--#-b-----------#-------?--------------------------------------------?---#-#-------------------------?----------------------------#------?-----------------#---#-------------------?--
----------------b##-#-------------##-#--------#-#-----------b?----?----------#---#---##--?-#-#------------#----?-?------------#-----?---------------####-------------#-#-----#--##----------------------
---------------#-##-#---#---------##-#bb------#-#----------------p-----------#----b--------#-#-------#----#-------------------#----------#---------######---b--------#-#-----##--#---------------b-bb---
---------------#-#####-##---------###---------#-#----------------p-----------###--------bb-#-#-------#----#-------------b-----#----------#---------#######-----------##------##--#----------------------
-----e---ee----##-#####-##-----ee--###---bb---#-#---e---e--------p------ee----###-------b---#-#------##b---#-----e-----#-------#---ee--------e----#######--b-----e--###-----###--#-------ee----#--b--b--
################-####---##--#########-#--#---##-##########--###-###--###########-##---#----#-##-######----##############-####-#-#########################----#-########----####--#-#############------#-
################-####---##--#########-#--#---##-##########--###-###--###########-##---#----#-##-######----##############-####-#-#########################----#-########----####--#-#############------#-