------------------------------------------------------------------------------------------------------------------------------------------------------
------------------------------------------------------------------------------------------------------------------------------------------------------
------------------------------------------------------------oo---------oo-----------------------------------------------------------------------------
--------------------------------------------------XXXXXXXXXX-------------ooo---o----------------------------------------------------------------------
------------------------------------------------------XX--XX------------------------------------------------------------------------------------------
------------------------------------------------------XX--XX-XX---XX----------------------------------------------------------------------------------
----------------------XXX---------------------------XX-------------------------------X-X------------------------------------------t-------------------
----------------------------------------------------XX-----------------X----------------------------oo------------------------------------------------
----------------------------------------------------XX----------------XX----------------------------------------------------------------XXX-----------
------------------------------------------------k---XX----oo----------------XXX-------------------oo--------------------------------------------------
---------------------------X-----------tt-----o-----XXXX--XX---------------XXXX-----XXXXX--------------------t--------X---tt------ttttt---------------
---------------------------X-----------tt-------------XX-------------------XXXXX----X----------tt------------t------------tt---X----------------------
---------------------------XX----------tt-------------XX------------------XXXXXX---kX----------tt------------t------------tt-ttXX---------------------
----------------------kk---XX----------tt--------------------XXXXXXXXXXXXXXXXXXX----X----------tt------------t------------tt-ttXXX------------------F-
XXXXXXXXXX----------XXXXXXXXXXXXXXXXXXXXXXXXXXXXXXXXXXXXXXXX-XXXXXXXXXXXXXXXXXXXXXXXXXX---XXXXXXXXXXXXXXXXXXXXXXXXXXXXXXtt--t-----t-------------------
XXXXXXXXXX----------XXXXXXXXXXXXXXXXXXXXXXXXXXXXXXXXXXXXXXXX-XXXXXXXXXXXXXXXXXXXXXXXXXX---XXXXXXXXXXXXXXXXXXXXXXXXXXXXXX------------------------------
