XXXXXXXXXXXXXXXXXXXXXXXXXXXXXXXXXXXXXX---------------------------X---XXXXXXXXXXXXXXXX------------XX-----------------------------------------------------t
XXXXXXXXXXXXXXXXXXXXXXXXXXXXXXXXXXXXXX-------------------------o-----XXXXXXXXXXXXXXXX-----------XXXX--------------------------------------------------XXX
------------------------------------------------------------------------------------------------XXXX--------------XXXXoX------------------------------XXX
----------------------------------------------------------------X---------------------------------------------------------------------------t------------
---------------------------------------XXXXXXXXXXXXX---o------X-X---------------------------------------------------------------------------t------------
-------------------------------o-------XXXXXXXXXXXXX----------XXX---------------------------------------------------------------------------t------------
-------------------------------------------------------------XXXX--------------------------------------X-------X-o--X--X--------------------X-------X----
----------------------------------------------------------X--XXXX-------------------X-------------------------t--------------Xt----------------t---------
-----------------------------------------------------XXXXXXXXXXXXXXX----------------X------------X------------t--------------Xt---X-t----------t---------
-----------X------------------tXoXX------------------XXXXXXXXXXXXXXX---o------------X------------X------------t--------------Xt---X-t----------t---------
------------------X--------t--t-------------------------------------X--------------XXXXXXX-------X-XXXXXXXXXXXXX---XXXX-XXXXXXXXXXXXXXXXXXXXXXXXXX----oF-
t------------------X--------tt-t---X---------------------------------X-------t------XXXXXXX-------X-XXXXXXXXXXXXX---XXXX-XXXXXXXXXXXXXXXXXXXXXXXXXX-----t
tX-----------------X--------tt-t---X---------------------------------X-------t------X------------XX-----------------------------------------------------t
