------------------------------------------------------------------------------------------------------------------------------------------------------
------------------------------------------------------------------------------------------------------------------------------------------------------
------------------------------------------------------------------------------------------------------------------------------------------------------
------------------------------------------------------------------------------------------------------------------------------------------------------
------------------------------------------------------------------------------------------------------------------------------------------------------
------------------------------------------------------------------------------------------------------------------------------------------------------
------------------------------------------------------------------------------------------------------------------------------------------------------
------------------------------------------------------------------------------------------------------------------------------------------------------
------------------------------------------------------------------------------------------------------------------------------------------------------
------------------------------------------------------------------------------------------------------------------------------------------------------
---tt------------------------------------------------------------------------------------------------X-----X------------------------------------------
---tt--------------tt--------------------------------------------------------------------------tt----------------------------------tt---XX------------
---tt--------------tt--------------------------------------------------------------------------tt----------------------------------tt-----------------
---tt------------kktt-----kk-------------------------------------------------------------------tt---------------------kkk----------tt---------------F-
XXXXXXXXXXX----XXXXXXXXXXXXXXX-----XXXXXXXXXXXXXXXXXXXXXXXXXXXX----XXXXXXXXX----XXXXXX----XXXXXXXXXXXXXXXXXXXXXXXXXXXXX-----XXXXXXXXXXXXXXXXXXXXXXXXXX
XXXXXXXXXXX----XXXXXXXXXXXXXXX-----XXXXXXXXXXXXXXXXXXXXXXXXXXXX----XXXXXXXXX----XXXXXX----XXXXXXXXXXXXXXXXXXXXXXXXXXXXX-----XXXXXXXXXXXXXXXXXXXXXXXXXX
