------------------------------------------------------------------------------------------------------------------------------------------------------
------------------------------------------------------------------------------------------------------------------------------------------------------
------------------------------------------------------------------------------------------------------------------------------------------------------
------------------------------------------------------------------------------------------------------------------------------------------------------
------------------------------------------------------------------------------------------------------------------------------------------------------
------------------------------------------------------------------------------------------------------------------------------------------------------
------------------------------------------------------------------------------------------------------------------------------------------------------
------------------------------------------------------------------------------------------------------------------------------------------------------
------------------------------------------------------------------------------------------------------------------------------------------------------
-----------------------------------------------XX--------------------------------------------------------------XXXX-----------------------------------
------tt---X----X--------------------------------------------------------------------tt---------------------------------------------------------------
------tt-----------------------------------------------------------------------------tt-------------------tt------------------------------------------
------tt-----------------------------------tt----------------------------------------tt-------------------tt-----------------------------tt-----------
------tt---------------------kk--------k---tt----------------------------------------tt----kk-------k-----tt---kkk-----------------------tt---------F-
XXXXXXXXXXXXXXXXXXXXXXXXXXXXXXXXXX---XXXXXXXXXXXXXXXXXXXXXX----XXXX----XXXXXX----XXXXXXXXXXXXX-----XXXXXXXXXXXXXXXXXXXXXXXXXXXXXX-----XXXXXXXXXXXXXXXX
XXXXXXXXXXXXXXXXXXXXXXXXXXXXXXXXXX---XXXXXXXXXXXXXXXXXXXXXX----XXXX----XXXXXX----XXXXXXXXXXXXX-----XXXXXXXXXXXXXXXXXXXXXXXXXXXXXX-----XXXXXXXXXXXXXXXX
