t--------XXXXX-----------------XXXX---------XXXXXXXXXXXXXXXXXXXXXXXXXXXXXXXXXXXXXXXXXXXXXXXXXXXXXXXXXXXXXXXXXXXX-----------------------------------------
t-------------X--------X---------------------------------------------------------------------------------------------------------------------------------
t----------------------------------------------------------------------------------------------------------------X---------------------------------------
t----------------------------------------------------------------------------------------------------------------X---------------------------------------
t-------o-XX------------------t-XoXXXXo------------------XooX-------------------------------o--------------------X---XX-X--------------------oo----------
t-----------------------------t----------------------------------------------------------------------------------XX-XXXXX--------------------------------
t------------t----------------t----------------------------------------------------------------------------------XX--XXXX--------------------------------
t------------t----------------t---------------------------------------------t------------X-------------------o---XX--XXXX--------------------------------
XXXXXXXXXX---XXXXXXXXXXXXXXXXXXXXXXXXXXX-X-------------o--XoX--------------Xt---------------ooo-------o----------XXXXXXXXXXXXXXXXXXXXXXXXXXXXXXXXXXXXXXXX
XXXXXXXXXX---XXXXXXXXXXXXXXXXXXXXXXXXXXX----------------------------------XXtttt-------------------------------X-XXXXXXXXXXXXXXXXXXXXXXXXXXXXXXXXXXXXXXXX
--------------------------------------------------------------------------XXttttt-----t----------------------tX----------------------------------------F-
t--------------------------------------------------------------------------XXttttt-----t---------------------ttX-----------------------------------------
t-------------------------------------------XXXXXXXXXXXXXXXXXXXXXXXXXXXXXXXXXXXXXXXXXXXXXXXXXXXXXXXXXXXXXXXXXXXX-----------------------------------------
