------------------------------------------------------------------------------------------------------------------------------------------------------
------------------------------------------------------------------------------------------------------------------------------------------------------
------------------------------------------------------------------------------------------------------------------------------------------------------
------------------------------------------------------------------------------------------------------------------------------------------------------
------------------------------------------------------------------------------------------------------------------------------------------------------
------------------------------------------------------------------------------------------------------------------------------------------------------
------------------------------------------------------------------------------------------------------------------------------------------------------
------------------------------------------------------------------------------------------------------------------------------------------------------
------------------------------------------------------------------------------------------------------------------------------------------------------
----------------------------------------------------------------------------------------tt----------------tt------------------------------------------
------------------tt--------------------------------------------------------------------tt----------------tt------------------------------------------
------------------tt--------------------------------------------------------------------tt----------------tt------------------------------------------
------------------tt--------------------------------------------------------------------tt----------------tt------------------------------------------
------------------tt--------------------------------------------------------------------tt----kkk---------tt-----------kkk--------------------------F-
XXXXXXXXXX-----XXXXXXXXXXXXXXXXXXXXXXXXXXXX---XXXXXXXXXX-----XXXXXXXXX----XXXXXX-----XXXXXXXXXXX-----XXXXXXXXXXXXXXXXXXXXXXXXXXXX----XXXXXXXXXXXXXXXXX
XXXXXXXXXX-----XXXXXXXXXXXXXXXXXXXXXXXXXXXX---XXXXXXXXXX-----XXXXXXXXX----XXXXXX-----XXXXXXXXXXX-----XXXXXXXXXXXXXXXXXXXXXXXXXXXX----XXXXXXXXXXXXXXXXX
