---X------------------X--------------XXXXXXX--X-----------------------o----------------------------------------------------------------------------------
---X------------------X-----------X--XXXXXXX-------------------------------------------------------------------------------------------------------------
---X---XXXXXXXXXXXXXX-XXXXo-------X-----------------------------------------------------------------------------------------t----------------------------
---X---XXXXXXXXXXXXXX-X-----------------------------------------------------------------------------------------------------t----------------------------
-tXX---X--------------------------------------------X-------o---------Xo------------------------o-----------------------o---X-------t------------t-------
-tXX---X---------------------------------oXX---------t---------------------------------------------------X-------------X------------t------------t-------
XXXXX--X----------------X-o-----X--------------------t---------------------------------------------------X-------------X------t-----t----------X-t-------
XXXXX--X---------------------------------------------t---------------------------------------------------X-------------X------t-----t-t------X-X-t-------
-------------------------------------------------XXXXXXXX-XXXXXXXXXXXXXXXXXXXXXXXXXXXXXXXXXXXXXXXXXXXXXXXXXXXXXXXXXXXXXXXXXXXXXXXXXXXXXXXXXXXXXXXXXX-XXXX
-------------------------------------------------XXXXXXXX-XXXXXXXXXXXXXXXXXXXXXXXXXXXXXXXXXXXXXXXXXXXXXXXXXXXXXXXXXXXXXXXXXXXXXXXXXXXXXXXXXXXXXXXXXX-XXXX
----------------------XXXXXXXXX------------------------------------------------------------------------------------------------------------------------F-
o----------------------XXXXXXXXX-------------------------------------------------------------------------------------------------------------------------
----------------------X----------------------------------------------------------------------------------------------------------------------------------
