--------------------------------------------------------------------------------------------------------------------------------------------------------------------------------------------------------
--------------------------------------------------------------------------------------------------------------------------------------------------------------------------------------------------------
--------o-------oo------oo-----------------------------oo-------------------------o----oo----------oo------------------------------------oo---------------------------oo-----------------oo----------oo-
-ooo-----ooo------ooo------------------------------ooo---------ooo-----------------ooo----------oo---------oo-----------oo----------oo---------oo-------------ooo-----------ooo---------------oo--------
--------------------------------------------------------------------------------------------------------------------------------------------------------------------------------------------------------
------------------------XXXXX----------------------------------------------XXXX---------------------------------XXXXXX------------------XX--------------------------------------------------------------
------------------X-------------------------------------------------------------------------------------------------------------------------------------------------------------------------------------
------------------X---------------------------------------------------------------------------------------XX-----------------t--------------------------------------------------------------------------
------XX---------XX--------------------------------------------------------------------------------------XXX-----------------t--------------------------------------------------------------------------
------XX--------XXX----------XXX-XX---XXXX------XXX------------XX--------------------------X--------------------XXX---------XXX-----------------------XX---X-------X-----------------------XX-----XXXX--
------X--------------------------X-XX--------------------------------------------X--------XX--------------------X----------XXXX-------------------------XX---------X------------------------------XXXX--
-----XX--------------------------X-XX-------tt------t--------X--X---------------XX-------XXX---------tt---t----XX--tt-----XXXXX-------------------------XX---------X-------------------XX---------XXXXF-
----XXX--------------------------X-XX-------tt------t---------XXX---------------XX------XXXX---------tt---t---XXX--tt----XXXXXX-------------------------XX--------XX-----------------------------XXXXX--
XXXXXXXXXXXXXXX-XXXXXXXXXXXXXXXXXX-XXXXXX---XX-XXXXXXXXXX---XXXXXX---XXXXXXXXXXXXXXXXXXXXXXXXXXXXXXXXXXXXXXXXXXXXX-XXXXXXXXXXXXXXXXXXXXXXXXXX--XXX-----XXXXXXXXXXXXXXX--XXXXXXXXX------XXXX------XXXXXXX
