--------------------------------------------------------------------------------------------------------------------------------------------------------------------------------------------------------
--------------------------------------------------------------------------------------------------------------------------------------------------------------------------------------------------------
-------oo-----oo--oo---------o-----oo-------------oo----------------------------------------oo----oo--oo------------------------------------oo---oo-----oo----------------------------------------------
-ooo--------------------------ooo--------ooo-----------ooo-------ooo---ooo-------------------------------------oo---------------oo------------------ooo------ooo--------------------------ooo------ooo--
--------------------------------------------------------------------------------------------------------------------------------------------------------------------------------------------------------
-------------------------------------XXXXXXXXXXX-------------XX--XXXXXX------------------------------------------------------------------------------------------XX-------------------------------------
--------------------------------------------------------------------------------------------------------------------------------------------------------------------------------------------------------
---------------------------------------------------------------------------------------------------------------------------------XX-------------t---------------------------------t---------------------
-------------------------------------------------------------------------------------------------------X-------------------------XX-------------t---------------------------------t---------------------
--------------------X-XXXX-----XX-----XXXX---------------------------------------------------------XX--X-------------------------XX---------XXXXXX------XXXXXX-----XX-----------XXXXX-------------------
---------------------------------X-------------------------------------------------------------------XXX-------------------------XX---------------------------------------------------------------------
--------XX----t-----------------XX-----tt-----tt----------------------------------------------------XXXX-----X-------------------XX------------------------------t----tt---XX-------------------------F-
--------------t-----------------XX-----tt-----tt----------------------------------------------------XXXX-----X------------------XXX------------------------------t----tt--------------------------------
XXXXXXXXXXXXXXXXXXXXX--XXXXXXXXXXX--XXXXXXXXXXXXXXXXXXXXXX---XXXXXX--XXXXXXXXXXXXXXXXXXXXXXXXXXXXXXXXXXXXXXXXXX-XXXXXXXXXXXXXXXXXXXXXXXXXXXXXX----XXXXXXXXXXXXXXXXXXXXXXXXXXXXXXXXXXXXXXXXXXXXXXXXXXXXXX
