--------------------------------------------------------------------------------------------------------------------------------------------------------------------------------------------------------
--------------------------------------------------------------------------------------------------------------------------------------------------------------------------------------------------------
------oo----oo------------------oo------oo---------oo----------------------------oo-----------oo----------o----------------------------------oo-----------oo----------------------oo------------------oo
-oo-----------------------ooo---------------------------------oo-------oo----oo---------ooo--------ooo-----oo---------ooo---------------------------ooo------------------------------ooo----------------
--------------------------------------------------------------------------------------------------------------------------------------------------------------------------------------------------------
---XXXX-----------------XXX-----------------------XXXXXXX---------------XXX-----------------------------------------------------------------------------------------------------------------------------
--------------------------------------------------------------------------------------------------------------------------------------------------------------------------------------------------------
--------------------------------------------------------------------------------------------------------------------------------------------------------------------------------------------------------
-----------------------------------------------------------------------------XX-------------------------------------------------------------------------------------------------------------------------
-----------------------------------------------------XXXXX-----------------XXXX-------------------------------------------------------XXX----------------X-X--------------XX-----------XX-------X-------
----------------------------------------------------XX---------------------X----------------------------------------------------------------------------------------------------------XXX---------------
------XX---------------------t-------------XX------XXX------------tt------XX-------------------XX-----------------tt-------------------------tt-----tt-------------t-----------------XXXX------t------F-
-----------------------------t-----X--------------XXXX------------tt-----XXX--k-----------------------------------tt-------------------------tt-----tt-------------t----------------XXXXX------t--------
XXXXXXXXXXXXXXXXX-----XXXXXXXXXX---XXXXXXXXXXXX---XXXX------XXXXXXXXXXX--XXXXXXXXXXXXXXX-----XXXXXXXXXXXXXXXXXXXXXXXXXXXXXXXXXXXXXXXX----XXXXXXXXXXXXXXXXXXXXXXXXXXXXXXXXXXXXX------XXXXXXXXXXXXXXXXXXXX
