--------------------------------------------------------------------------------------------------------------------------------------------------------------------------------------------------------
--------------------------------------------------------------------------------------------------------------------------------------------------------------------------------------------------------
-----oo----oo--------------------------------------------------------------------------oo--------oo------------oo---------oo-------oo-------------oo------oo-----------------------------oo--------oo---
-oo----------ooo------------------------------ooo-------------------oo-----ooo----------------------------------------ooo----------------------------------------------------------ooo------------------
--------------------------------------------------------------------------------------------------------------------------------------------------------------------------------------------------------
---------------------------------------------------------------------------------------------------------XXX-----------------------------------------------------------------------XXXXXXXXXXXXXXXXXXXXX
--------------------------------------------------------------------------------------------------------------------------------------------------------------------------------------------------------
------------------------------------------------------------------------------------------------------------------------------XXXX----------------------------------------------------------------------
------------------------------------------------------------------------------------------------------------------------------XXXX----------------------------------------------------------------------
-------------------------------------XXXXX-XXXXXXXXX----X--------X-------------------------------------X----------------------XXXX----------------------------------------------------------------------
-------------------------------------------------------XX--X-------------------------------------------X---------------------XXXXX----------------------------------------------------------------------
--------tt--t-----------------------------------------XXXXXX----------X-------------------------------XX--------------------XXXXXX----------X-------------------------tt------------------tt----------F-
--------tt--t--------------k--------------------------XXXXXX---------XX-------------------------------XX-------------------XXXXXXX----------X-------------------------tt------------------tt-----------X
XXXX----XXXXXXXXXXXXXXXXXXXXXXXXXXXXXXXXXXXXXXXXXXXX--XXXXXXXXXXXX---XXXXXXXXXXXXXX---XXXXXXXXXXXX-XXXXXXXXXXXXXX-XXXXXXXXXXXXXXXXXXXXXXXXXXXXXXXXXXXXXXXXXX---XXXXX--XXXXXXXXXXXXXX---XXXXXXXXXXXXXXXXX
