--------------------------------------------------------------------------------------------------------------------------------------------------------------------------------------------------------
--------------------------------------------------------------------------------------------------------------------------------------------------------------------------------------------------------
----------------------o-----------------------------------------------------------------oo--------oo---------------oo---------------------------------oo------------------------------------------------
-ooo--ooo---ooo--------oo---------------ooo---oo-----ooo--ooo----ooo------ooo-------------------------------ooo---------------------------ooo------------------------------------ooo--oo----ooo------ooo
--------------------------------------------------------------------------------------------------------------------------------------------------------------------------------------------------------
----XX------------------------------------------------------------XXXXXXX----------------------------------------------------XXXXX--------XXXXXXX-----------------------XX------XXXX--------------------
--------------------------------------------------------------------------------------------------------------------------------------------------------------------------------------------------------
--------------------------------------------------------------------------------------------------------------------------------t-----------------------------------------------------------------------
----------------------XX--------------------------------------------------------------------------------------------------------t------------------------------------------------XX---------------------
----------------------XX----------------------------------------------------------------------------------------------X-----XXXXXX-----------------------------------------------XX---------------------
--------------------------------------------------------------------------------------------------------------------------------------------------------------------------------XXX---------------------
----------------------XX--------------------------------------------------XX------------------t-------X--t--------------------------------tt---------------X--------------------XXX-------------------F-
----------------------------------X-------------------------------------------------------X---t------XX--t--------------------------------tt--------------XX-------------------XXXX---------------------
XXXXXXXXX---XXXXXXXXXXXXX---------XXXXXXXXXXXXXXXXXXXXXXXXXXXXXXXX-XXXXXXXXXXXXXXXXXXXX---XXXXXXXXXXXXXXXXXXXXXXXXXXXXXXXXXXXXXXXXXXXXXXXXXXXXXXXXXXXXXXXXXXXXXXXXXXXXXXXXXXXXXXXXXX--XXXXXXXXX--------X
