------------------------------------------------------------------------------------------------------------------------------------------------------
------------------------------------------------------------------------------------------------------------------------------------------------------
------------------------------------------------------------------------------------------------------------------------------------------------------
X-----XXXX------------------------------XXXXXXXXXX-----------------XXX------------------------------XXXXXXXXXX----------------------------------------
X-----------------------------------------------------------------------------------------------------------------------------------------------------
X----------------------------------------------------------X-------------------------------------XXX-----------------------------------X--------------
X---------------------XXX----------------oooo--------------------XX-----------------XX-----------------------------oo----------XXX--------------------
X----------------------------------------------------------------------tttttt-------------------------------------------------------------------------
X----------------------------------------XXXX---------------XX----------------------------------------------------------------------------------------
X----------------X----------------------oX--XoX-------------------------------------------XXXX----------------------------------k---------------------
X---------X-----XX---------X--X------X--XX--XXX----X-X--X-------------------------X--------------X---------tt--tttt--ttt-------XXX----X-----X---------
X--------------XXX---------X----------X-----------------X-------------------------X----------t--XX------X--tt-------------------------X-----XX--------
X-------------XXXX---------XX---------X-----------------X-------------------------XX---------t--XX-----XX--tt------------tt-----------X-----XXX------X
X------------XXXXX----kk---XX-------k-X---kk------------Xk------------------------XX--------XXXXXXXXkk-XX--tt-o----------tt----------XX---X-XXXX----FX
XXXXXXXXXXXXXXXXXXXXXXXXXXXXXXttttt--t-tXXXXXXXXXXtttttt-------XXXXXXX------------XXXXXXXX--XXXXXXXXXXXXX--XX-t---------XXXXXXXXXX-t---ttt-tXXXXXXXXXX
XXXXXXXXXXXXXXXXXXXXXXXXXXXXXX----------XXXXXXXXXX-------------XXXXXXX------------XXXXXXXX--XXXXXXXXXXXXX--XX-----------XXXXXXXXXX----------XXXXXXXXXX
