------------------------------------------------------------------------------------------------------------------------------------------------------
------------------------------------------------------------------------------------------------------------------------------------------------------
------------------------------------------------------------------------------------------------------------------------------------------------------
------------------------------------------------------------------------------------------------------------------------------------------------------
------------------------------------------------------------------------------------------------------------------------------------------------------
------------------------------------------------------------------------------------------------------------------------------------------------------
------------------------------------------------------------------------------------------------------------------------------------------------------
------------------------------------------------------------------------------------------------------------------------------------------------------
------------------------------------------------------------------------------------------------------------------------------------------------------
------------------------------------------------------------------------------------------------------------------------------------------------------
-------------------------------------------------------------------------------------------------------------tt-----------------------------tt--------
-------------------------------------------------------------------------------------------------------------tt-----------------------------tt--------
--------------------------------------------tt------------------------------------tt-------------------------tt-----------------------------tt--------
--------------------------------------------tt------------------------------------tt-----------------------kktt-----------------------------tt------F-
XXXXXXX-----XXXXXXXXXX-----XXXXXXX-----XXXXXXXXXXXXXXXXXXX---XXXXX---XXXXXX---XXXXXXXXXXXX-----XXXXX----XXXXXXXXXXXXXXXX---XXXXXXXXXX---XXXXXXXXXXXXXX
XXXXXXX-----XXXXXXXXXX-----XXXXXXX-----XXXXXXXXXXXXXXXXXXX---XXXXX---XXXXXX---XXXXXXXXXXXX-----XXXXX----XXXXXXXXXXXXXXXX---XXXXXXXXXX---XXXXXXXXXXXXXX
