------------------------------------------------------------------------------------------------------------------------------------------------------
------------------------------------------------------------------------------------------------------------------------------------------------------
------------------------------------------------------------------------------------------------------------------------------------------------------
------------------------------------------------------------------------------------------------------------------------------------------------------
------------------------------------------------------------------------------------------------------------------------------------------------------
------------------------------------------------------------------------------------------------------------------------------------------------------
------------------------------------------------------------------------------------------------------------------------------------------------------
------------------------------------------------------------------------------------------------------------------------------------------------------
------------------------------------------------------------------------------------------------------------------------------------------------------
-----------kkk----------------------------------------------------------------------------------------------------------------------------------------
-----------X--X-------------------tt------------------------------------------------------------------------------------------------------------------
----tt----------------------------tt-----------------------------------------------------------------------------------tt-----------------------------
----tt----------------------------tt-----------------------------------------------------------------------------------tt-----------------------------
----tt-----------------k----------tt--------k------------------------------------------------------------------------kktt---kkk---------------------F-
XXXXXXXXXXXXXXXXXXXXXXXXX----XXXXXXXXXXXXXXXXX----XXXXXXXXX---XXXXXX---XXXXXX---XXXXXX----XXXXXXXXXXXXXXXXXXXX-----XXXXXXXXXXXXXXXXXXXXXX---XXXXXXXXXX
XXXXXXXXXXXXXXXXXXXXXXXXX----XXXXXXXXXXXXXXXXX----XXXXXXXXX---XXXXXX---XXXXXX---XXXXXX----XXXXXXXXXXXXXXXXXXXX-----XXXXXXXXXXXXXXXXXXXXXX---XXXXXXXXXX
