------------------------------------------------------------------------------------------------------------------------------------------------------
------------------------------------------------------------------------------------------------------------------------------------------------------
----------------------------------oo------------------------------------------------------------------------------------------------------------------
------------------------------------------------------------------------------------------------------------------------------------------------------
------------------------------------------------------------------------------------------------------------------------------------------------------
------------------------------------------------------------------------------------------------------------------------------------------------------
------------------X------------------------------------------------------------------XXXX-XXX------t---------------oo----XXX----X---------------------
------------------------------------------------------------------------------------------------------------------------------------------------------
------------------------------------------------------------------------------------------------------------------------------------------------------
------------------------------------------------------------------------------------------------------------------------------------------------------
--------------tt---------X----------------------------X-------------------------------------ttt-------tttttt---tttt--ttt---------X--------------------
--------------tt----------------------------------tt--------X--------X-----------------------------------------------------------------------------X--
--------------tt----------------------------------tt--------X--tt-X-XX-------------------------------------------------------------------------k---X--
--------------tt----------X---XXXXXXXXXX----------tt------k-X-Xtt-XXXX----------------------------------------o-------------------k----------------XF-
XXXXXXXXXXXXXXXXXXXXtttttt--t-XXXXXXXXXXXXXXXXXXXXXXXXXXXXXX-t---t--------------XXXXX----X----------tt------ttt---------XXXXXXXXXXXX---XXXXXXXXXX--XXX
XXXXXXXXXXXXXXXXXXXX----------XXXXXXXXXXXXXXXXXXXXXXXXXXXXXX--------------------XXXXX----X------------------------------XXXXXXXXXXXX---XXXXXXXXXX--XXX
