to----------X---------t------------------t----------------------------------------X---------------X------------------------------------------------------
t----------tX---------t------------------t-------------t----t---------------------X---------------X---------t---------------------------Xt---------------
t----------tX--------Xt------------------t-------------t----t---------------------X---------------X-----t---t---------------------------Xt---------------
t-------X--XX-t-XXXXXXXXXXXXXXXXXXXXXXXXXXtXXXXXXXXXXXXXXXXXXXXXXXXXXXXXXXXXXX----XXXXXXXX-XXXXX-XXXXXXXXXXXXXXXXXXXXXXXXXXXXXXXX-XXXXXXXXXXXXXXXXXXXXXXX
t-------X--XX-t-XXXXXXXXXXXXXXXXXXXXXXXXXXXXXXXXXXXXXXXXXXXXXXXXXXXXXXXXXXXXXX----XXXXXXXX-XXXXX-XXXXXXXXXXXXXXXXXXXXXXXXXXXXXXXX-XXXXXXXXXXXXXXXXXXXXXXX
XXXXX-XXXXXXXXXX-------------------------------------------------------------X---------------------------------------------------------------------------
XXXXX-XXXXXXXXXX-------------------------------------------------------------X---------------------------------------------------------------------------
----------------------------------------------------------------------------XXXX-------------------------------------------------------------------------
-----------------------------XX-XX-XX-----------X---------------------XXoXXXXXXX------------------------------------------------------------------------X
---------------------------------------------------------------------------------------------------------------------------------------------------------
-------------------------------------------------------------------------------------------------------------------------------------------------------F-
t--------------------------------------------------------------------------------------------------------------------------------------------------------
t-----------------------------X-X-X--X-----XoXXXoX--X----------------X-XX--ooo----X------------------------o---------------------------------------------
