--------------------------------------------------------------------------------------------------------------------------------------------------------------------------------------------------------
--------------------------------------------------------------------------------------------------------------------------------------------------------------------------------------------------------
--------------------oo----------oo-------------------------------oo--------------------oo----------------------------------------------------oo-------------------------------------oo----oo---oo-------
-ooo----ooo----ooo------------------------ooo----------------------------ooo---ooo-----------ooo------------------ooo---------ooo--------ooo--------ooo---ooo-----ooo--------------------------------ooo
--------------------------------------------------------------------------------------------------------------------------------------------------------------------------------------------------------
---------XXXXXXX----------------------------------------------------------XXXX-------XXXXXXXXXXXXXXXXX--XXX--------------------------XXX--------------------------------------XXX-----------------------
--------------------------------------------------------------------------------------------------------------------------------------------------------------------------------------------------------
-----------------------------------------------------------------------------------------------------------------------------------------------------------t--------------------------------------------
---------------------------------------------------------------------------------------------------------------------------------------XXXX----------------t--------------------------------------------
----------------------------------------------------XXX-----XXXXX-X--------------------------XXX---------------XX----------------------XXXX-------------XXXXXXX-----------------------------------------
--------------------------------------------------------------------------------------------XXXX---------------------------------------X----------------------------------------------------------------
------------------------------------tt---------------tt----------------------tt-------tt----XXXX---------------------tt----------------X----------------tt--------X-----------------------------------F-
-----X------------------------------tt---------------tt---------k------------tt-------tt---XXXXX---------------------tt----------------X----X-----------tt-------XX-------------------------------------
XXXX-XXXXXXXXXXXXXXXXXXXXXXXXXXXX--XXXXXXXXXXXXXXX---XXXXXXXXXXXXXXXXXXXXXXXXXXXXX----XXXXXXXXXXXXXXXXXXXXXXXXXXXX---XXX----XX---XXXXXXX---XXXXXXXXXXXX-XXXXXXXXXXXXXXXXXXX-XXXXXXXXXXXXXXXXXXXXXXXXXXXX
