------------------------------------------------------------------------------------------------------------------------------------------------------
------------------------------------------------------------------------------------------------------------------------------------------------------
------------------X-----------------------------------------------------------------------------------------------------------------------------------
----------o---------------------------------------------------------------------------------------------------XXXXXXXXXX-----------oo--ooo------------
------------------------------------------------------------------------------------------------------------------------------------------------------
-------------------------------------------------------oooo-------------------------------------------------------------------------------------------
----------------XXX-X----------------------------------tttt----XXX------------------XX----------------------------------------------------------------
----------XooXo-XXX--------tt-------------------------------------------------------------------------------------------------------------------------
---------------------------tt----------------------------------------------------------------------------------------------------------------XXX--o---
---------------------------XX---------------------XXX------------------------------------------oooo------------------------------------X----XX--------
-----------------------tt------------------------------------X-----tt-------------X---------------------------t-----------------------------XX--X-----
-----------XXXXX-oXX---tt-------------tt---------------------------tt-------------X---------------------------t-----------------------------XX--------
-----------XXXXX-------tt-------------tt---------------------------tt-------------XX--------------------------t----tt-----------------------XX---XXX--
-----------XXXXX----k--tt-------------tt---------------------------tt-------------XX--------------------------t----tt----k--------XXX-XXXXXXXX------F-
XXXXXXXXXX-XXXXX----XXXXXXXXXXXXXXXXXXXXXXXXXXXXXX----ttttt-XXXXXXXXXXXXXXXXXXXX--XXXXXXXXttttttt-ttXXXXXXXXX-XXXXXXXXXXXXXXXXXXXXXXX-XXXXXXXX------XX
XXXXXXXXXX-XXXXX----XXXXXXXXXXXXXXXXXXXXXXXXXXXXXX----------XXXXXXXXXXXXXXXXXXXX--XXXXXXXX----------XXXXXXXXX-XXXXXXXXXXXXXXXXXXXXXXX-XXXXXXXX------XX
