--------------------------------------------------------------------------------------------------------------------------------------------------------------------------------------------------------
--------------------------------------------------------------------------------------------------------------------------------------------------------------------------------------------------------
--------------------oo----------------------------------------oo------------------------oo---------------------oo---------------------oo-------------------------oo-------------------------------------
-ooo----------------------------------------------oo----ooo-------------------------ooo----------------oo--------------------------oo------ooo-------------ooo---------------ooo------------------------
--------------------------------------------------------------------------------------------------------------------------------------------------------------------------------------------------------
-----------------------------------------------XXX--------------------------------------------XXXXXX--------------XX-----------XXXXXXXXXXXX--------------------------------------------------------XXXXX
--------------------------------------------------------------------------------------------------------------------------------------------------------------------------------------------------------
---------------------------------------------------------------------------------------------------------------t----------------------------------------------------------------------------------------
---------------------------------------------------------------------------------------------------------------t--------------------------------------------------XX----------------XX------------------
-----------XXXX----------------X---XXXX-----------------XX------------------------------------------------XX--XXXXX--X----------XX-----------------------------------------XX------XXX------------------
----------XXXXX---------------XX-----------------------XXX------------------------------------------------XX-------------------XXX-----------------X----------------------XX-XX---XX--------------------
----------XXXXX--------------XXX-----------------XX---XXXXXX------------tt--------------XX----XX----------XX------tt-----------XXX-----------------X------------X--------XXX-XX---XX------------------F-
---------XXXXXX-------------XXXX---k-----------------XXXXXXX------------tt----------------------------X--XXX------tt----------XXXX----------------XX-----------XX-------XXXX-XX---XX--------------------
XXXXXXXXXXXXXXXXXX--XXXXXX--XXXXXXXXXXXX--XXXX-XXX---XXXXXXXXXXXXXXXXXX-XXXXXXXXXXXX---------XXX---XXXXXXXXXXXXX--XXXXXXXXXX--XXXXXXX-----XX--XXXXXXXXX-----XXXXX-------XXXX-XX---XX-----------XX---XXXX
