t--------------------------------------------------------X----------------------------------XX--t------X--t-tt-----t----t--------------------------------
t--------------------------------------------------------X----------------------------------XX--t------XX-t-tt---X-t----t--------------------------------
t--------------------------------------------XXXXXXXX-XXXX--------------------------------X-XXXXXXXXXXXXXXXXXXXXXXXXXXXXXXX---X----------------------t---
t------------X-oo------X---------------------XXXXXXXX-XXXX------ooXXX---------------------X-XXXXXXXXXXXXXXXXXXXXXXXXXXXXXXX---X--------------t-------t---
t------------X-------X-------------------------------------------------------X---------------------------------------------------------------t-------t---
t-----------tX-------X-------------------------------------------------------X---------------------------------------------------------------t-------t---
t-----------tX------XX------------------t------------------------------------XX----------X----------------------------------XXX-XXXXXXXXX--XXXXXXXXXXXXXX
XXXXXXXXXXXXXXXXXXXXXX---------------X--t-------------------------Xo-oo----XXXX----------X------o---------------------------XXX-XXXXXXXXX--XXXXXXXXXXXXXX
XXXXXXXXXXXXXXXXXXXXXX--------t---t-----t----------------------------------XXXX--------------------------------------------------------------------------
------------------------------t---t-----t----------------------------------XXXX-----X-------X------------------------------------------------------------
------------------------------t---t-----t----------------------------------XXXX-----X-------X------------t---------------------------------------------F-
t------------------------XXXXXXXXXXX-XXXXXXX-XoX----------XXXXXXXXXXXXXXXX-XXXXXXXXXXXXXX-X--X------------t------------ot-----XX-------------------------
t-------------X----------XXXXXXXXXXX-XXXXXXX-------------XXXXXXXXXXXXXXXXX-XXXXXXXXXXXXXX---XX------------t--------t----t--------------------------------
