-------------------------------o--------------------------------------------------------------------------------XXXXXXXXX---XXXXXXXX---------------------
------------------------------o--o----------------------------------------X--XX---XoX-t-------------------------XXXXXXXXX---XXXXXXXX---------------------
-----------------o------------X-o-----------------------------------------------------t------------------------------------------------------------------
------------------------------X-------------------------------------------------------t------------------------------------------------t-----------------
---------t--------------------X-------------------------------------------------------t------------------------------------------------t-----------------
---------t------------------XXXXXXXXXXXXXXXXXXXXXXXXXXXXXXXXXXXXXXXXXXXXXXXXXXXXXXXXXXXXXXXXXXXXXXXXXXXXXXXXXX---oXoXXoXo---------XXo--Xo----------------
XXXXXXXXXXXXXXX---o-X----X--XXXXXXXXXXXXXXXXXXXXXXXXXXXXXXXXXXXXXXXXXXXXXXXXXXXXXXXXXXXXXXXXXXXXXXXXXXXXXXXXXX-------------------------------------------
XXXXXXXXXXXXXXX------------------------------------------------------------------------------------------------------------------------------------------
-----------------------X---------------------------------------------------------------------------------------------------------------------------X-----
-----------------------X--------------------------------------------------------------------------------------------X-XXX---------oXXXXXXXXXXXXXXXXXXXXXX
----------------XX--XXXXXXX-Xo------------------------------------------XoXXXX--------X-----------------------------------------t--XXXXXXXXXXXXXXXXXXXXFX
X---------------XXX--XXXXXXX-----------------------------------------------------------------------------------------------------t-----------------------
---------------------------------------------------------------------------------------------------------------------------------t-----------------------
