--------------------------------------------------------------------------------------------------------------------------------------------------------------------------------------------------------
--------------------------------------------------------------------------------------------------------------------------------------------------------------------------------------------------------
-------------oo-------------------oo------------------------oo---------oo----------------------------------------------o-------------------------------------oo-------------------oo---------o----------
-ooo----oo----------oo---------------------ooo---------------------------ooo---ooo----oo--------------------------------ooo--------oo--ooo---------ooo----------------ooo--------------ooo----ooo-------
--------------------------------------------------------------------------------------------------------------------------------------------------------------------------------------------------------
-----------------------------------------------XXXXXX--------XX---XX---------------XXXXX---------XXXXXXXXX----------------------------------XXXXXXXXX----------XXX--------------------------------------
--------------------------------------------------------------------------------------------------------------------------------------------------------------------------------------------------------
-----------------------------------------------------------------------X----------t------------------------------------------------------------------------------XXXXXX---------------------------------
-----------------X----------------------------------------------------XX----------t--XXX------------------------------------------------------------------------XXXXXXX---------------------------------
------------------XXX-------------------------------------------------------XXX--XXXXXXX--XXXX-----------------XXXX-------------XX-----X------------XXXX--------XXXXXXX--------XXXXXXX------------------
---------------------------------------------------------------------------XXXX--X---------------X-----------------XX----------XXX----------------------X-----------------------------------------------
---------------------------------------------------XX----------------------XXXXXXX-----------t--XX--------tt------XXX----------XXX---------------X------X--------------------------------tt-----------F-
-----k--------------------------------------------------------------------XXXXXXXX-----------t--XX--------tt-----XXXX---------XXXX--------------XX-----XX------------------------k-------tt------------k
XXXXXXXXXXXXXXXXXXXXXXXXXXXXXXXXXXXXXXXXXXXXXXXXXXXXXXXXXXXX-XXXXXXXXXXXXXXXXXXXXXXXXX------XXXXXXXXXXXXXXXXXXX--XXXXXXXXXXX--XXXXXXX-XXXXXXXXXXXXXXXXXXXXXXXXXXXXXXXXXX--XXXXXXXXXXXXXXXXXXXX----XXXXXX
