---------------------------------------------------------------------X---------tt-----------------t----X-------------------------------------------------
---------------------------------------------------------------------X---------tt-----------------t----X-------------------------------------------------
------------------X---------------------------------------XXXXXXXXXX-XXXXXXXXXXXXXXXXXX-XXXXXXXXXXXXXXXX-------------------------------------------------
---XXXXXXXo-------------X---------XX----------------------XXXXXXXXXX-XXXXXXXXXXXXXXXXXX-XXXXXXXXXXXXXXXXXo--------------------------------o--------------
-------------------------------------------------------------------------------------------------------------t----------------------------------t--------
-------------------------------------------------------------------------------------------------------------t----------------------------------t--------
----------------XXX------------------------o---------------------------------X-------------------------------t---------o--------X---------------t--------
-----XX-XoXooXo-XXX-----------------o------------------------------------------------------------------XX-oXXXoo--------------oXX-------to------X--------
---------------------------t------------X----------------------------------------------------------------------X-t-------------XX-------t-------------t--
---------------------------t------------X----------------------------------------------------------------------X-t-X-----------XX-------t------------Xt--
---------------------------t------------X----------------------------------------------------------------------X-t-X-----------XX-------t-------------tF-
X-XXXXXXXX-XXXXX-oXX-XXXXXXXXXXXXXXXXXXXXXXXXXXXXXXXXXXX-------------X---------tt--------o--------------XXXXXXXXXXXXXXXXXXXXXXXXXXXXXXXXXXX--XXXXXXX-XXXX
--XXXXXXXX-XXXXX-----XXXXXXXXXXXXXXXXXXXXXXXXXXXXXXXXXXX-------------X---------tt-----------------t-----XXXXXXXXXXXXXXXXXXXXXXXXXXXXXXXXXXX--XXXXXXX-XXXX
