--------------------------------------------------------------------------------------------------------------------------------------------------------------------------------------------------------
--------------------------------------------------------------------------------------------------------------------------------------------------------------------------------------------------------
----------------oo------oo-----------------------------------oo-----------------oo---------oo------------------------------------oo------------o-----------------------------------oo--oo---------------
-oo--------oo-----ooo----------------------------ooo-----------------ooo------------------------------------oo--------ooo--oo-----------oo------ooo-----------oo----------ooo-------------ooo-----oo--oo
--------------------------------------------------------------------------------------------------------------------------------------------------------------------------------------------------------
------------------------------------------------------------------------------------XXX-----------------XXXXXXX----XXX--XXXX-----------------------------------------------------XXXXXX-----------------
------------------------------------------------------------------------------------------------------------------------------------------------------------------------------------------X-------------
----------------XX------------------------------------------------------------------------------------------------------------XXX---------------------------------------------------------X-------------
------------XXXXXX------------------------------------------------------------------------------XXX---------------------------XXX------------------------------------------------------XXXX-------------
------------XXXXXX----------------XXX--XXXX----------X-X-----------XXXX------------XXX---XXX---------------------X---------------XXXXX-----XX--------------------------------------XXXXXXXX------X------
----------------------------------XXX--XXXX------------------------XXXX-----------XXXX--XX--------------------------------------------------------------X----------------------------------XX----X------
----t-------tt-------------------XXXXXXXXXXXX------XX--------------XXXX-----------XXXXXXXX------------X---------------------------------tt---------tt---X---------------------------------XXX----X----F-
----t-------tt-------------------XXXXXXXXXXXX----------------------XXXX-------k--XXXXXXXXX-----------XX-----------------------k---------tt---------tt--XX--------------------------------XXXX---XX------
XXXXXXXXX---XXXXXXXXXXXXX--XX----XXXXXXXXXXXX--XXXXXXXX--------XXXXXXXXXXXXXXXXX-XXXXXXXXXXXXXXXXXXXXXXXXXXXXXXXXXXXXXXXXXXXXXXXXXXXXXXXXXXXXXXXXXXXXX-XX----XXXXX--XXXXXX--XXXXXXXXXX---XXXXXXXXXXXXXXX
