--------------------------------------------------------------------------------------------------------------------------------------------------------------------------------------------------------
--------------------------------------------------------------------------------------------------------------------------------------------------------------------------------------------------------
------------------oo-------------------------o-------------------oo---------------------------------------------------------oo--oo-----------oo----------------------------------------oo---------------
-ooo----------------------------ooo---ooo-----ooo-------ooo-----------------------ooo----ooo------------oo--------------ooo-------------------------------------------------ooo-------------------------
--------------------------------------------------------------------------------------------------------------------------------------------------------------------------------------------------------
-----------------XX---------XXXX--------XX-----------------------------XXX-----------------------------------------XXXX-----------XXXX------------------------------------------------------------------
--------------------------------------------------------------------------------------------------------------------------------------------------------------------------------------------------------
------------------------------------------------------t------------------t-------------t----------------------------------------------------------------------------------------------------------------
------------------------------------------------------t------------------t-------------t----------------------------------------------------------------------------------------------------------------
---------------XXXXX--------------------------------XXX--XX------X-XX--XXXXXX--XXXXXXXXX--XXX----------XXX-------------------------------------------------------------------------------XXX------------
---------------X------------------------------------------------XX-XX--X-----XXXXXXXXXXX----------------------------------------------------------------------------------------------------------------
-----------t--XX-----------------------tt--t--------XX--t-------XX-XXXXX-----XXXXXXXXXXX---------------------------------------------------------------------tt----------XX---------------------------F-
-----------t--XX-----------------------tt--t------------t------XXX-XXXXX-----XXXXXXXXXXX---------------------------------------k--------k----k---------------tt-----------------------------------------
XX----XXXXXXXXXXXXXXXXXXXXXXXXXXXXXXXXXXXXXXXXXXXXXXXXXXXXX----XXX-XXXXXXXX--XXXXXXXXXXXXXXXXXXXXXXXXXXXXXXXXXXXXXXXXXXXXXXXXXXXXXXXXXXXXXXXXXXXX--XXXXXX----XXXXXXXXXXX--XXXXXXXXXXXXXXXXXXXXXXXXXXXXXX
