--------------------------------------------------------------------------------t---------------------------------------------------------------------
--------------------------------------------------------------------------------t---------------------------------------------------------------------
--------------------------------------------------------------------------------XXXXXXX-XX------------------------------------------------------------
---XXXXXXX-----------------------------------------oo---------------------------XXXXXXX-XX----------XXXXXXXXXX----------ooo---------------------------
--------------------------------------------------tttt------------------------------------------------------------------------------------------------
----------------------oook----------------------------------------------------------------------------------------------------------------------------
---------------------ttttt---------------------------------------------------------------------------------------------------------X------------------
-----XX-Xo---------------------------------------------XXX--------------------------------------------------------------------------------------------
----------------------------------------------------------------------o-------------------------------------------------------------------------------
--------------------------------------------------------------------------------------------------oo----------------------------XX--------------------
--------------------ttttttt----------------------------------------------------------------------------------t-----------------XXXX------X------------
X-XXXXXXXX----------------------------k-t-----tt---------------------t--------X-t--------o-----tt------tt----t-X---------------XXX------XX------------
--XXXXXXXX------------------o-tttt------t-----tt--t----------X-------t-------XX-t--------------tt------tt----t-X--------------XXXX-----XXX------------
--XXXXXXXX---------X-------ttttttt------t-----tt---------------------t----------t--------------tt------tt----t-X--------XXXX--XXXX----XXXX---------XF-
--XXXXXXXXXXX--XXXXX----------XXXXXXXXXXXXXX--XXXX----------XXXXXX--XXXXXXXXXXXXt---------XXXXXXXXXXXXXXXXXXXX-XXXXXXXXXXXXX--XXXXXXXXXXXXXXXXXXXXXXXX
--XXXXXXXXXXX--XXXXX----------XXXXXXXXXXXXXX--XXXX----------XXXXXX--XXXXXXXXXXXXt---------XXXXXXXXXXXXXXXXXXXX-XXXXXXXXXXXXX--XXXXXXXXXXXXXXXXXXXXXXXX
