--------------------------------------------------------------------------------------------------------------------------------------------------------------------------------------------------------
--------------------------------------------------------------------------------------------------------------------------------------------------------------------------------------------------------
--------------------------------------------------------------------------------------------------------------------------------------------------------------------------------------------------------
--------------------------------------------------------------------------------------------------------------------------------------------------------------------------------------------------------
--------------------------------------------------------------------------------------------------------------------------------------------------------------------------------------------------------
-X-X-X--XX--XX---X-------------------------X---------------X--------------------------X----------X-------X----------X------------------X-------------X--------X--X-XXXX-----------X---------------------
--------------------------------------------------------------------------------------------------------------------------------------------------------------------------------------------------------
--------------------------------------------------------------------------------------------------------------------------------------------------------------------------------------------------------
--------------------------------------------------------------------------------------------------------------------------------------------------------------------------------------------------------
--------------------------------------------------------------------------------------------------------------------------------------------------------------------------------------------------------
--X---tt--------X-X------X----X------X--------X--X-X-X--X-------------------X-----XX---X----X--X---XX-X-------XX-X-X--X---tt----------X---------Xtt---------------X-----tt-X---tt--tt-X-----------------
--X---tt------------------------------X-----------------X---X--------X-------X--X-X----X----X---------X---ttX-XX--X---X---tt---X------X---------Xtt---------X--tt-------tt-----tt--tt--tt---------------
--X---tt--tt--------------------------X-----------------X---X--tt-X-XX---XX--X-XX-X----X----X---------X---ttX-XX--X---X---tt-ttXX-----X---------Xtt---X--tt-X--tt-------tt-----tt--tt--tt---------------
--X---tt--tt---X----------X---------k-X-----k-----------Xk--X-Xtt-XXXX---XX--XXXX-X-k--X----X---------X---ttX-XXX-X---X---tt-ttXXX---XX---X--k--Xtt---X-ktt-X--tt-------tt--X--tt--tt--tt-------------F-
tt--tt--------t-ttt-tttttt--t-ttttt--t-t---t--tttttttttt-----t---t----ttt--tt------t------tt---tt-tttt-tt--------t-t-t-ttt--t------t---ttt-t--tt-------t-----tt---tttt-t--tt--t--t----t--ttttttttttttttt
--------------------------------------------------------------------------------------------------------------------------------------------------------------------------------------------------------
