--------------------------------------------------------------------------------------------------------------------------------------------------------------------------------------------------------
--------------------------------------------------------------------------------------------------------------------------------------------------------------------------------------------------------
----------oo--oo---------------------oo--------------o-----------------------------------------------------------------------------------oo--oo-------------------oo---------oo-------------------------
-ooo----------------------ooo--ooo--------------oo----ooo------------ooo-----------------ooo--ooo-----oo----------------ooo-------ooo------------------oo-----ooo-------ooo-----------ooo---------------
--------------------------------------------------------------------------------------------------------------------------------------------------------------------------------------------------------
-------XXXXX----------------------------------------------------------------XXXXXX---XXX--------------------------------------XXXXXX-------------XXXXXX-------------------------------------------------
--------------------------------------------------------------------------------------------------------------------------------------------------------------------------------------------------------
---------------------------------------------------------------------------------------------------------X------------XXXXXX----------------------------------------------------------------------------
---------------------------------------------------------------------------------------------------------X----------XXXXXXXX-----------------------------XX--------------XX-----------------------------
-------------------------------------------------------------------------------X---------------X---------X----------XXXXXXXX------------------------X--XXXX--------------------XXXXXXX------------------
--------------------------------------------------------------------------------------------------------XX----------------------------------------------------------------------------------------------
----------------------------------tt------------------------------------tt-----X-------------t---X-----XXX--------------------------------XX----------------------XX----------------------------------F-
----------------------------------tt--------k---------------------------tt-----X-------------t---X-----XXX----------------------------------------------------------------------------------------------
XXXXXXXXXXXXXXXXXXXXXXXXXXXXX--XXXXXXXXXXXXXXXXXXXXXXXXXXXXXXX---XXXXXXXXXXXXXXX------XXXXXXXXXXXXXXXXXXXX-----XXXXXXXXXXXXXXXXXXXXXXXXXXXXXXXXXXXXXXXXXXXXXXXXXX---XXXXXXXXXXXXXXX--XXXXXXXXXXXXXXXXXXX
