------------X--XXXXXXXX-XXXXXXXXXXXXXXXXXXXX--------------------------------X--t-----------------------------------------------------------------------------------------
------------X--XXXXXXXXXXXXXXXXXXXXXXXXXXXX
-------------------------------XX--t----------------------------------------------
------------------------------------------
---------------XXXXXXXXXXXXXXXXXXXXXXXXXXXX
-------------------------------X-o-------------------------------------------------------------------------------------------
t-----------X--XXXXXXXXXXX-XXXXXXXXXXXXXXXX--------------------------------X-o-------------------------------------------------------------------------------------------
t----------X--
XXXXXXXXXXX-XXXXXXXXXXXXXXXX---------X---
--------------------o-X-------------------------
---------------------------------------------------------------
-------------XXXXX-XXXXXXX-XXXXXXXXXXXXXXXX---------X------------------------o-X-----------------------------------------------------------------------------------------
-------------XXXXX-XXXXXXXX-XXXXXXXXXXXXXXX------------X---------------------X-X-----------------------------------------------------------------------------------------
----X------X-XXXXX--XXXXXXX-XXXXXXXXXXXXXXX------------X---------------------X-X-----------------------------------------------------------------------------------------
-----------X--XX-X--XXXXXXXXXXXXXXXXXXXXXXX-------t-----------------------------X----------------------------------------------------------------------------------------
o-------t--X--XXtXX-XXXX-XXXXXXXXXXXXXXXXXX-------t-----------------------------X----------------------------------------------------------------------------------------
X-------t--X--XXXXX-XX-X-XXXXXXXXXXXXXXXXXX---------------------------
-------t-X----------------------------------------------------------------------------------------
-o-------------XXXXXXXX-XXXXXXXXXXXXXXXXXXXX-----------------------------------t-----------------------------------------------------------------------------------------
-o-------------XXXXXXXXXXXXXXXXXXXXXXXXXXXXX--------------------------------X--------------------------------------------------------------------------------------------
