p--------B#BBB-----------------BBBB---------####################################################################-----------------------------------------
p-------------B--------B---------------------------------------------------------------------------------------------------------------------------------
P----------------------------------------------------------------------------------------------------------------#---------------------------------------
P----------------------------------------------------------------------------------------------------------------#---------------------------------------
P-------?-##------------------p-B?BBBB?------------------B??B-------------------------------?--------------------#---##-#--------------------??----------
P-----------------------------p----------------------------------------------------------------------------------##-B####--------------------------------
P------------p----------------p----------------------------------------------------------------------------------##--####--------------------------------
P------------p----------------p---------------------------------------------p------------B-------------------?---##--####--------------------------------
##########---###########################-B-------------?--B?B--------------#p---------------???-------?----------########################################
##########---###########################----------------------------------##pPpp-------------------------------B-########################################
--------------------------------------------------------------------------##pPppP-----p----------------------P#------------------------------------------
p--------------------------------------------------------------------------##pPppP-----p---------------------pP#-----------------------------------------
p-------------------------------------------####################################################################-----------------------------------------