---#------------------#--------------#######--B-----------------------?----------------------------------------------------------------------------------
---#------------------#-----------#--#######-------------------------------------------------------------------------------------------------------------
---#---##############-#BBB?-------#-----------------------------------------------------------------------------------------P----------------------------
---#---##############-#-----------------------------------------------------------------------------------------------------P----------------------------
-p##---#--------------------------------------------B-------?---------B?------------------------?-----------------------?---#-------p------------p-------
-p##---#---------------------------------?BB---------P---------------------------------------------------#-------------#------------p------------p-------
#####--#----------------B-?-----#--------------------P---------------------------------------------------#-------------#------P-----p----------#-P-------
#####--#---------------------------------------------P---------------------------------------------------#-------------#------P-----p-P------#-#-P-------
-------------------------------------------------########-##########################################################################################-####
-------------------------------------------------########-##########################################################################################-####
----------------------#########--------------------------------------------------------------------------------------------------------------------------
?----------------------#########-------------------------------------------------------------------------------------------------------------------------
----------------------#----------------------------------------------------------------------------------------------------------------------------------