------------#--########-####################--------------------------------B--p-----------------------------------------------------------------------------------------
------------#--############################
-------------------------------BB--P----------------------------------------------
------------------------------------------
---------------############################
-------------------------------B-?-------------------------------------------------------------------------------------------
p-----------#--###########-################--------------------------------B-?-------------------------------------------------------------------------------------------
P----------#--
###########-################---------B---
--------------------?-#-------------------------
---------------------------------------------------------------
-------------#####-#######-################---------B------------------------?-#-----------------------------------------------------------------------------------------
-------------#####-########-###############------------#---------------------B-#-----------------------------------------------------------------------------------------
----#------#-#####--#######-###############------------#---------------------B-#-----------------------------------------------------------------------------------------
-----------#--##-#--#######################-------p-----------------------------B----------------------------------------------------------------------------------------
?-------p--#--##p##-####-##################-------P-----------------------------B----------------------------------------------------------------------------------------
#-------P--#--#####-##-#-##################---------------------------
-------p-B----------------------------------------------------------------------------------------
-?-------------########-####################-----------------------------------P-----------------------------------------------------------------------------------------
-?-------------#############################--------------------------------B--------------------------------------------------------------------------------------------