-------------------------------?--------------------------------------------------------------------------------#########---########---------------------
------------------------------?--?----------------------------------------B--BB---B?B-P-------------------------#########---########---------------------
-----------------?------------#-?-----------------------------------------------------P------------------------------------------------------------------
------------------------------#-------------------------------------------------------P------------------------------------------------P-----------------
---------P--------------------#-------------------------------------------------------P------------------------------------------------P-----------------
---------P------------------##################################################################################---?B?BB?B?---------BB?--#?----------------
###############---?-B----B--##################################################################################-------------------------------------------
###############------------------------------------------------------------------------------------------------------------------------------------------
-----------------------#---------------------------------------------------------------------------------------------------------------------------#-----
-----------------------#--------------------------------------------------------------------------------------------B-BBB---------?######################
----------------##--#######-B?------------------------------------------B?BBBB--------B-----------------------------------------p--######################
B---------------B##--#######-----------------------------------------------------------------------------------------------------p-----------------------
---------------------------------------------------------------------------------------------------------------------------------p-----------------------