######################################---------------------------B---################------------##-----------------------------------------------------p
######################################-------------------------?-----################-----------####--------------------------------------------------###
------------------------------------------------------------------------------------------------####--------------BBBB?B------------------------------###
----------------------------------------------------------------#---------------------------------------------------------------------------P------------
---------------------------------------#############---?------#-#---------------------------------------------------------------------------P------------
-------------------------------?-------#############----------###---------------------------------------------------------------------------P------------
-------------------------------------------------------------####--------------------------------------B-------B-?--B--B--------------------#-------#----
----------------------------------------------------------#--####-------------------#-------------------------p--------------#P----------------P---------
-----------------------------------------------------###############----------------#------------#------------p--------------#P---#-P----------P---------
-----------B------------------pB?BB------------------###############---?------------#------------#------------p--------------#P---#-P----------P---------
------------------#--------p--p-------------------------------------#--------------#######-------#-#############---####-##########################----?--
P------------------#--------pP-p---#---------------------------------#-------P------#######-------#-#############---####-##########################-----p
P#-----------------#--------pP-p---#---------------------------------#-------P------#------------##-----------------------------------------------------p