                                                                                                                                                                                                        
                                                                                                                                                                                                        
                    .+          .+                               .+                    .+                                                    .+                                     .+    .+   .+       
 ..+    ..+    ..+                        ..+                            ..+   ..+           ..+                  ..+         ..+        ..+        ..+   ..+     ..+                                ..+
                                                                                                                                                                                                        
         @@@@@@@                                                          @@@#       #@@@@@@@@@@@@@@@#  @@@                          @@@                                      @@@                       
                                                                                                                                                                                                        
                                                                                                                                                           $                                            
                                                                                                                                       @@@@                $                                            
                                                    @@@     ##### #                          @@@               @@                      @@@@             @@@@@@@                                         
                                                                                            @@@@                                       @                                                                
                                    %%               %%                      %%       %%    @@@@                     %%                @                %%        @                                     
     @                              %%               %%         &            %%       %%   @@@@@                     %%                @    @           %%       @@                                     
@@@@ @@@@@@@@@@@@@@@@@@@@@@@@@@@@  @@@@@@@@@@@@@@@   @@@@@@@@@@@@@@@@@@@@@@@@@@@@@    @@@@@@@@@@@@@@@@@@@@@@@@@@@@   @@@    @@   @@@@@@@   @@@@@@@@@@@@ @@@@@@@@@@@@@@@@@@@ @@@@@@@@@@@@@@@@@@@@@@@@@@@@
