                                                                                                                                                                                                        
                                                                                                                                                                                                        
                  .+                         .                   .+                                                         .+  .+           .+                                        .+               
 ..+                            ..+   ..+     ..+       ..+                       ..+    ..+            .+              ..+                                                 ..+                         
                                                                                                                                                                                                        
                 @@         @@@#        @@                             @@@                                         @@@#           #@@#                                                                  
                                                                                                                                                                                                        
                                                      $                  $             $                                                                                                                
                                                      $                  $             $                                                                                                                
               @@@@@                                @@@  @@      @ @@  @@@@@@  @@@@@@@@@  @@@          @@@                                                                               @@@            
               @                                                @@ @@  @     @@@@@@@@@@@                                                                                                                
           $  @@                       %%  $        ##  $       @@ @@@@@     @@@@@@@@@@@                                                                     %%          ##                             
           $  @@                       %%  $            $      @@@ @@@@@     @@@@@@@@@@@                                       &        &    &               %%                                         
@@    @@@@@@@@@@@@@@@@@@@@@@@@@@@@@@@@@@@@@@@@@@@@@@@@@@@@@    @@@ @@@@@@@@  @@@@@@@@@@@@@@@@@@@@@@@@@@@@@@@@@@@@@@@@@@@@@@@@@@@@@@@@@@@@@@@@@@@@  @@@@@@    @@@@@@@@@@@  @@@@@@@@@@@@@@@@@@@@@@@@@@@@@@
