                                                                                                                                                                                                        
                                                                                                                                                                                                        
          .+  .+                     .+              .                                                                                   .+  .+                   .+         .+                         
 ..+                      ..+  ..+              .+    ..+            ..+                 ..+  ..+     .+                ..+       ..+                  .+     ..+       ..+           ..+               
                                                                                                                                                                                                        
       @@@@#                                                                @@@@@@   @@#                                      @@@@@@             #@@@@#                                                 
                                                                                                                                                                                                        
                                                                                                         @            @@@@@@                                                                            
                                                                                                         @          @@@@@@@@                             @@              @@                             
                                                                               #               #         @          @@@@@@@@                        #  @@@@                    @@@@@@@                  
                                                                                                        @@                                                                                              
                                  %%                                    %%     @             $   @     @@@                                ##                      ##                                    
                                  %%        &                           %%     @             $   @     @@@                                                                                              
@@@@@@@@@@@@@@@@@@@@@@@@@@@@@  @@@@@@@@@@@@@@@@@@@@@@@@@@@@@@@   @@@@@@@@@@@@@@@      @@@@@@@@@@@@@@@@@@@@     @@@@@@@@@@@@@@@@@@@@@@@@@@@@@@@@@@@@@@@@@@@@@@@@@@   @@@@@@@@@@@@@@@  @@@@@@@@@@@@@@@@@@@
