                                                                                                                                                                                                        
                                                                                                                                                                                                        
       .+     .+  .+         .     .+             .+                                        .+    .+  .+                                    .+   .+     .+                                              
 ..+                          ..+        ..+           ..+       ..+   ..+                                     .+               .+                  ..+      ..+                          ..+      ..+  
                                                                                                                                                                                                        
                                     #@@@@@@@@@@             @@  @@@@@@                                                                                          @@                                     
                                                                                                                                                                                                        
                                                                                                                                 @@             $                                 $                     
                                                                                                       @                         @@             $                                 $                     
                    # ####     @@     ####                                                         ##  @                         @@         @@@@@@      @@@@@@     @@           @@@@@                   
                                 @                                                                   @@@                         @@                                                                     
        ##    $                 @@     %%     %%                                                    @@@@     @                   @@                              $    %%   ##                           
              $                 @@     %%     %%                                                    @@@@     @                  @@@                              $    %%                                
@@@@@@@@@@@@@@@@@@@@@  @@@@@@@@@@@  @@@@@@@@@@@@@@@@@@@@@@   @@@@@@  @@@@@@@@@@@@@@@@@@@@@@@@@@@@@@@@@@@@@@@@@@ @@@@@@@@@@@@@@@@@@@@@@@@@@@@@@    @@@@@@@@@@@@@@@@@@@@@@@@@@@@@@@@@@@@@@@@@@@@@@@@@@@@@@
