                                                                                                                                                                                                        
                                                                                                                                                                                                        
                    .+                                        .+                        .+                     .+                     .+                         .+                                     
 ..+                                              .+    ..+                         ..+                .+                          .+      ..+             ..+               ..+                        
                                                                                                                                                                                                        
                                               @@#                                            @@@@@#              @@           @@@@@@@@@@@@                                                        @@@@@
                                                                                                                                                                                                        
                                                                                                               $                                                                                        
                                                                                                               $                                                  @@                @@                  
           @@@@                @   @@@@                 @@                                                @@  @@@@@  #          @@                                         @@      @@@                  
          @@@@@               @@                       @@@                                                @@                   @@@                 @                      @@ @@   @@                    
          @@@@@              @@@                 ##   @@@@@@            %%              ##    ##          @@      %%           @@@                 @            @        @@@ @@   @@                    
         @@@@@@             @@@@   &                 @@@@@@@            %%                            @  @@@      %%          @@@@                @@           @@       @@@@ @@   @@                    
@@@@@@@@@@@@@@@@@@  @@@@@@  @@@@@@@@@@@@  @@@@ @@@   @@@@@@@@@@@@@@@@@@ @@@@@@@@@@@@         @@@   @@@@@@@@@@@@@  @@@@@@@@@@  @@@@@@@     @@  @@@@@@@@@     @@@@@       @@@@ @@   @@           @@   @@@@
