                                                                                                                                                                                                        
                                                                                                                                                                                                        
                .+      .+                                   .+                 .+         .+                                    .+            .                                   .+  .+               
 .+        .+     ..+                            ..+                 ..+                                    .+        ..+  .+           .+      ..+           .+          ..+             ..+     .+  ..
                                                                                                                                                                                                        
                                                                                    #@@                 @@@@@@#    @@@  @@@#                                                     #@@@@#                 
                                                                                                                                                                                          @             
                @@                                                                                                            @@@                                                         @             
            @@@@@@                                                                              @@@                           @@@                                                      @@@@             
            @@@@@@                @@@  @@@@          # #           @@@@            @@@   @@@                     #               #####     @@                                      @@@@@@@@      @      
                                  @@@  @@@@                        @@@@           @@@@  @@                                                              @                                  @@    @      
    $       %%                   @@@@@@@@@@@@      ##              @@@@           @@@@@@@@            @                                 %%         %%   @                                 @@@    @      
    $       %%                   @@@@@@@@@@@@                      @@@@       &  @@@@@@@@@           @@                       &         %%         %%  @@                                @@@@   @@      
@@@@@@@@@   @@@@@@@@@@@@@  @@    @@@@@@@@@@@@  @@@@@@@@        @@@@@@@@@@@@@@@@@ @@@@@@@@@@@@@@@@@@@@@@@@@@@@@@@@@@@@@@@@@@@@@@@@@@@@@@@@@@@@@@@@@@@@@ @@    @@@@@  @@@@@@  @@@@@@@@@@   @@@@@@@@@@@@@@@
