                                                                                                                                                                                                        
                                                                                                                                                                                                        
        .       .+      .+                             .+                         .    .+          .+                                    .+                           .+                 .+          .+ 
 ..+     ..+      ..+                              ..+         ..+                 ..+          .+         .+           .+          .+         .+             ..+           ..+               .+        
                                                                                                                                                                                                        
                        #@@@@                                              #@@@                                 @@@@@@                  @@                                                              
                  @                                                                                                                                                                                     
                  @                                                                                       @@                 $                                                                          
      @@         @@                                                                                      @@@                 $                                                                          
      @@        @@@          @@@ @@   @@@@      @@@            @@                          @                    @@@         @@@                       ##   #       @                       @@     @@@@  
      @                          @ @@                                            @        @@                    @          @@@@                         @@         @                              @@@@  
     @@                          @ @@       %%      $        #  @               @@       @@@         %%   $    @@  %%     @@@@@                         @@         @                   ##         @@@@  
    @@@                          @ @@       %%      $         @@@               @@      @@@@         %%   $   @@@  %%    @@@@@@                         @@        @@                             @@@@@  
@@@@@@@@@@@@@@@ @@@@@@@@@@@@@@@@@@ @@@@@@   @@ @@@@@@@@@@   @@@@@@   @@@@@@@@@@@@@@@@@@@@@@@@@@@@@@@@@@@@@@@@@@@@@ @@@@@@@@@@@@@@@@@@@@@@@@@@  @@@     @@@@@@@@@@@@@@@  @@@@@@@@@      @@@@      @@@@@@@
