------------------------------------------------------------------------------------------------------------------------------------------------------
------------------------------------------------------------------------------------------------------------------------------------------------------
------------------------------------------------------------------------------------------------------------------------------------------------------
------------------------------------------------------------------------------------------------------------------------------------------------------
------------------------------------------------------------------------------------------------------------------------------------------------------
------------------------------------------------------------------------------------------------------------------------------------------------------
------------------------------------------------------------------------------------------------------------------------------------------------------
------------------------------------------------------------------------------------------------------------------------------------------------------
------------------------------------------------------------------------------------------------------------------------------------------------------
-----------rrr----------------------------------------------------------------------------------------------------------------------------------------
----------!S!!S!------------------tt------------------------------------------------------------------------------------------------------------------
----tt----------------------------tt-----------------------------------------------------------------------------------tt-----------------------------
----tt----------------------------tt-----------------------------------------------------------------------------------tt---------------------------F-
-M--tt-----------------k------yy--tt--------r------------------------------------------------------------------------kktt---rrr---------------------#-
XXXXXXXXXXXXXXXXXXXXXXXXX----XXXXXXXXXXXXXXXXX----XXXXXXXXX---XXXXXX---XXXXXX---XXXXXX----XXXXXXXXXXXXXXXXXXXX-----XXXXXXXXXXXXXXXXXXXXXX---XXXXXXXXXX
XXXXXXXXXXXXXXXXXXXXXXXXX----XXXXXXXXXXXXXXXXX----XXXXXXXXX---XXXXXX---XXXXXX---XXXXXX----XXXXXXXXXXXXXXXXXXXX-----XXXXXXXXXXXXXXXXXXXXXX---XXXXXXXXXX
