------------------------------------------------------------------------------------------------------------------------------------------------------
------------------------------------------------------------------------------------------------------------------------------------------------------
------------------------------------------------------------------------------------------------------------------------------------------------------
------------------------------------------------------------------------------------------------------------------------------------------------------
------------------------------------------------------------------------------------------------------------------------------------------------------
------------------------------------------------------------------------------------------------------------------------------------------------------
------------------------------------------------------------------------------------------------------------------------------------------------------
------------------------------------------------------------------------------------------------------------------------------------------------------
------------------------------------------------------------------------------------------------------------------------------------------------------
----------------------------------------------------------------------------------------------------------yy------------------------------------------
---tt------------------------------------------------------------------------------------------------@CLCLC@------------------------------------------
---tt--------------TT--------------------------------------------------------------------------TT----------------------------------tt---SS------------
---tt--------------TT--------------------------------------------------------------------------TT----------------------------------tt---------------F-
-M-tt--gg--------KKTT-----rr---------------------------------------------------------------gg--TT---------------------kkk---g------tt-------------gg#-
XXXXXXXXXXX----XXXXXXXXXXXXXXX-----XXXXXXXXXXXXXXXXXXXXXXXXXXXX----XXXXXXXXX----XXXXXX----XXXXXXXXXXXXXXXXXXXXXXXXXXXXX-----XXXXXXXXXXXXXXXXXXXXXXXXXX
XXXXXXXXXXX----XXXXXXXXXXXXXXX-----XXXXXXXXXXXXXXXXXXXXXXXXXXXX----XXXXXXXXX----XXXXXX----XXXXXXXXXXXXXXXXXXXXXXXXXXXXX-----XXXXXXXXXXXXXXXXXXXXXXXXXX
