------------------------------------------------------------------------------------------------------------------------------------------------------
------------------------------------------------------------------------------------------------------------------------------------------------------
------------------------------------------------------------------------------------------------------------------------------------------------------
S-----SSSS------------------------------SSSSSSSSSS-----------------SSS------------------------------SSSSSSSSSS----------------------------------------
S-----------------------------------------------------------------------------------------------------------------------------------------------------
S----------------------------------------------------------X-------------------------------------XXX-----------------------------------X--------------
S--------------------LSSS----------------oooo-------------------CSS--------g-------USS-----------------------------oo----------SSS--------------------
S----------------------------------------------------------------------%%%%%%-------------------------------------------------------------------------
S----------------g-----------------------SSSS-U-------------SS--2-------||||--------------------------------------------------------------------------
S----------------#----------------------oS--SoS----------------2-2------||||--------------XXXX----------------------------------K---------------------
S---------S-----##---2-----#--X------X--SS--SSS----X-X--X---------2-----||||------#--------------X---------TT--%%%%--%%%-------SSS----X-----#---------
S--------------###---------#----------X-----------------X---------------||||------#----------t--XX------#--TT---||----||--------------X-----##--------
S-------------####---------##---------X-----------------X---------------||||------##---------t--XX-----##--TT---||----||-TT-----------X-----###------#
S------------#####----kk---##-------k-X---kk------------Xk--------------||||------##--gg----XXXXXXXXkk-##--TT-o-||----||-TT----------XX---X-####----##
XXXXXXXXXXXXXXXXXXXXXXXXXXXXXXttttt--t-tXXXXXXXXXXtttttt-------XXXXXXX--||||------XXXXXXXX--XXXXXXXXXXXXX--XX-%-||----||XXXXXXXXXX-t---ttt-tXXXXXXXXXX
XXXXXXXXXXXXXXXXXXXXXXXXXXXXXX----------XXXXXXXXXX-------------XXXXXXX--||||------XXXXXXXX--XXXXXXXXXXXXX--XX---||----||XXXXXXXXXX----------XXXXXXXXXX
