------------------------------------------------------------------------------------------------------------------------------------------------------
------------------------------------------------------------------------------------------------------------------------------------------------------
------------------------------------------------------------oo---------oo-----------------------------------------------------------------------------
--------------------------------------------------SSSSSSSSSS-------------ooo---o----------------------------------------------------------------------
------------------------------------------------------SS--SS------------------------------------------------------------------------------------------
------------------------------------------------------SS--SS-XX---XX----------------------------------------------------------------------------------
---------------------LSSS---------------------QQQQ--SS-------------------------------SUS------------------------------------------%-------------------
----------------------------------------------------SS-----------------X----------------------------oo------------------------------------------------
----------------------------------------------------SS----------------XX----------------------------------------------------------------SSS-----------
------------------------------------------------k---SS----oo----------------XXX-------------------oo--------------------------------------------------
---------Q-----------2-----#-----------TT-----?QQQ--SSSS--SS---------------XXXX-----#####--------------------T--!-----S---tt------%%%%%---------------
---------------------------#-----------TT-------------SS-------------------XXXXX----#----------TT------------T------------tt---X---|||----------------
---------------------------##----------TT-------------SS------------------XXXXXX---K#----------TT------------T------------tt-ttXX--|||----------------
----------------------kk---##---gg-----TT--------------------XXXXXXXXXXXXXXXXXXX----#-------y--TT---------y--T------------tt-ttXXX-|||----------------
XXXXXXXXXX----------XXXXXXXXXXXXXXXXXXXXXXXXXXXXXXXXXXXXXXXX-XXXXXXXXXXXXXXXXXXXXXXXXXX---XXXXXXXXXXXXXXXXXXXXXXXXXXXXXXtt--t-----%|||----------------
XXXXXXXXXX----------XXXXXXXXXXXXXXXXXXXXXXXXXXXXXXXXXXXXXXXX-XXXXXXXXXXXXXXXXXXXXXXXXXX---XXXXXXXXXXXXXXXXXXXXXXXXXXXXXX-----------|||----------------
