------------------------------------------------------------------------------------------------------------------------------------------------------
------------------------------------------------------------------------------------------------------------------------------------------------------
------------------------------------------------------------------------------------------------------------------------------------------------------
------------------------------------------------------------------------------------------------------------------------------------------------------
------------------------------------------------------------------------------------------------------------------------------------------------------
------------------------------------------------------------------------------------------------------------------------------------------------------
----------------------------------------------------------------------------------------------------------------CC------------------------------------
------------------------------------------------------------------------------------------------------------------------------------------------------
------------------------------------------------------------------------------------------------------------------------------------------------------
------------yy---------------------------------SS--------------------------------------------------------------@@@@-----------------------------------
------TT---SCLLCS--------------------------------------------------------------------tt---------------------------------------------------------------
------TT-----------------------------------------------------------------------------tt-------------------tt------------------------------------------
------TT-----------------------------------tt----------------------------------------tt-------------------tt-----------------------------tt---------F-
-M----TT---------------------rr--------K---tt-------g-----------------------------RR-tt----kk-------K-----tt---rrr-----------------------tt-----gg--#-
XXXXXXXXXXXXXXXXXXXXXXXXXXXXXXXXXX---XXXXXXXXXXXXXXXXXXXXXX----XXXX----XXXXXX----XXXXXXXXXXXXX-----XXXXXXXXXXXXXXXXXXXXXXXXXXXXXX-----XXXXXXXXXXXXXXXX
XXXXXXXXXXXXXXXXXXXXXXXXXXXXXXXXXX---XXXXXXXXXXXXXXXXXXXXXX----XXXX----XXXXXX----XXXXXXXXXXXXX-----XXXXXXXXXXXXXXXXXXXXXXXXXXXXXX-----XXXXXXXXXXXXXXXX
