------------------------------------------------------------------------------------------------------------------------------------------------------
------------------------------------------------------------------------------------------------------------------------------------------------------
----------------------------------oo------------------------------------------------------------------------------------------------------------------
------------------------------------------------------------------------------------------------------------------------------------------------------
------------------------------------------------------------------------------------------------------------------------------------------------------
------------------------------------------------------------------------------------------------------------------------------------------------------
------------------SC-----------------------------------------------------------------SSSS-SSS------%---------------oo----SSS----S!--------------------
------------------------------------------------------------------------------------------------------------------------------------------------------
------------------------------------------------------------------------------------------------------------------------------------------------------
------------------------------------------------------------------------------------------------------------------------------------------------------
--------------TT---2-----X----------------------------S-------------------------Q-----------%%%-------%%%%%%---%%%%--%%%---------S--------------------
--------------TT----------------------------------TT--------X--------X-----------------------|---------||||-----||----||---------------------------#--
--------------TT----------------------------------TT--------X--tt-X-XX-----------------------|---------||||-----||----||-----------------------K---#--
-M------------TT----------X---XXXXXXXXXX----y-y---TT------k-X-Xtt-XXXX-----------ggg---------|---------||||---o-||----||----gg-g-gk----------------#--
XXXXXXXXXXXXXXXXXXXXtttttt--t-XXXXXXXXXXXXXXXXXXXXXXXXXXXXXX-t---t--------------XXXXX----X---|------%%-||||-%%%-||----||XXXXXXXXXXXX---XXXXXXXXXX--XXX
XXXXXXXXXXXXXXXXXXXX----------XXXXXXXXXXXXXXXXXXXXXXXXXXXXXX--------------------XXXXX----X---|------|--||||--|--||----||XXXXXXXXXXXX---XXXXXXXXXX--XXX
