------------------------------------------------------------------------------------------------------------------------------------------------------
------------------------------------------------------------------------------------------------------------------------------------------------------
------------------------------------------------------------------------------------------------------------------------------------------------------
------------------------------------------------------------------------------------------------------------------------------------------------------
------------------------------------------------------------------------------------------------------------------------------------------------------
------------------------------------------------------------------------------------------------------------------------------------------------------
------------------------------------------------------------------------------------------------------------------------------------------------------
------------------------------------------------------------------------------------------------------------------------------------------------------
------------------------------------------------------------------------------------------------------------------------------------------------------
----------------------------------------------------------------------------------------tt----------------tt------------------------------------------
------------------tt-L-L----------------------------------------------------------------tt----------------tt------------------------------------------
------------------tt--------------------------------------------------------------------tt----------------tt------------------------------------------
------------------tt--------------------------------------------------------------------tt----------------tt----------------------------------------F-
-M----------------tt-------gg-----------------------------------------------------------tt----rrr------gg-tt-----------kkk--------------------------#-
XXXXXXXXXX-----XXXXXXXXXXXXXXXXXXXXXXXXXXXX---XXXXXXXXXX-----XXXXXXXXX----XXXXXX-----XXXXXXXXXXX-----XXXXXXXXXXXXXXXXXXXXXXXXXXXX----XXXXXXXXXXXXXXXXX
XXXXXXXXXX-----XXXXXXXXXXXXXXXXXXXXXXXXXXXX---XXXXXXXXXX-----XXXXXXXXX----XXXXXX-----XXXXXXXXXXX-----XXXXXXXXXXXXXXXXXXXXXXXXXXXX----XXXXXXXXXXXXXXXXX
