------------------------------------------------------------------------------------------------------------------------------------------------------
------------------------------------------------------------------------------------------------------------------------------------------------------
------------------X-----------------------------------------------------------------------------------------------------------------------------------
----------o---------------------------------------------------------------------------------------------------SSSSSSSSSS-----------oo--ooo------------
------------------------------------------------------------------------------------------------------------------------------------------------------
-------------------------------------------------------oooo-------------------------------------------------------------------------------------------
----------------XXX-S----------------------------------%%%%---USSS-----------------USS----------------------------------------------------------------
----------XooXo-XXX--------TT---------------------------||-------------------------------------------------------------------------------------y------
---------------------------TT---------------------------||-----------------------------------------------------------------------------------#SS--o---
---------------------------XX---------------------SSS---||-------------------------------------oooo------------------------------------X----##--------
-----------------------TT-------------------------------||---S-----TT-------------#---------------------------T-----------------------------##--SC----
-----------XXXXX-oXX---TT-------------tt--------------U-||---------TT-------------#---------------------------T-----------------------------##--------
-----------XXXXX-------TT-------------tt----------------||---------TT-------------##----------------------*---T----TT-----------------------##---SSS--
-M---------XXXXX----k--TT-------------tt----y-y---------||---ggg---TT-gg----------##--gg------------gg----*---T--g-TT----k----ggg-XXX-XXXXXX##--------
XXXXXXXXXX-XXXXX----XXXXXXXXXXXXXXXXXXXXXXXXXXXXXX----%%%%%-XXXXXXXXXXXXXXXXXXXX--XXXXXXXX%%%%%%%-%%XXXXXXXXX-XXXXXXXXXXXXXXXXXXXXXXX-XXXXXXXX------XX
XXXXXXXXXX-XXXXX----XXXXXXXXXXXXXXXXXXXXXXXXXXXXXX-----|||--XXXXXXXXXXXXXXXXXXXX--XXXXXXXX||||||---|XXXXXXXXX-XXXXXXXXXXXXXXXXXXXXXXX-XXXXXXXX------XX
