P------------------p---------#------------#-----?-------------p----###########################--########-----------------------------------------------------------------
P--p--------P------#-----B---#------------#--??---------------p----###########################--########-----------------------------------------------------------------
P--p-----p--P----pp-------p####-------------------------------p--------------------------------------------------------------------------------------p-------------------
PPpp----ppP-P----pp-------p####-------------------------------pP--------------------------------------------------------##---------------------------p-------------------
PPpp----ppP-P----pp-------p####-------------------------------pP-------------------------------------------------------####----------------#-##------p-------------------
##############################################-##----#############----------?BBBB?BBBBBBBBB-------------------B------B-####---pPPP--------##-##------##----------------B-
##############################################-##----#############-----------------------------------------------------####---pPPP--------######------#------------------
----------------------------------------------------------------------------------------------------------------------#####--#pPPP--------######------#-----pP-----------
----------------------------------------------------------------------------------------------------------------------#####-##pPPP--------######------#-----pP-----------
----------------------------------------------------------------------------BB#-----B?--??BB?--#-------------B--#################################-############-##########
-----------------------------------------P---------------------------p-pP----------p-----------#----------------#################################-############-##########
P-B---------------------------------------P---------------------------pPpP----------p---P-------#------------------------------------------------------------------------
P------------------p----------------------P-------------------p-------pPpP----------p---P-------#------------------------------------------------------------------------