P?----------#---------P------------------P----------------------------------------#---------------#------------------------------------------------------
P----------p#---------P------------------P-------------p----p---------------------#---------------#---------P---------------------------#p---------------
P----------p#--------#P------------------P-------------p----p---------------------#---------------#-----p---P---------------------------#p---------------
P-------#--##-P-##########################p###################################----########-#####-################################-#######################
P-------#--##-P-##############################################################----########-#####-################################-#######################
#####-##########-------------------------------------------------------------#---------------------------------------------------------------------------
#####-##########-------------------------------------------------------------#---------------------------------------------------------------------------
----------------------------------------------------------------------------####-------------------------------------------------------------------------
-----------------------------BB-BB-BB-----------B---------------------BB?BBB####------------------------------------------------------------------------B
---------------------------------------------------------------------------------------------------------------------------------------------------------
---------------------------------------------------------------------------------------------------------------------------------------------------------
P--------------------------------------------------------------------------------------------------------------------------------------------------------
P-----------------------------#-#-B--B-----#?BBB?B--#----------------B-BB--???----#------------------------?---------------------------------------------