P--------------------------------------------------------#----------------------------------##--p------#--P-pp-----p----P--------------------------------
P--------------------------------------------------------#----------------------------------##--p------##-P-pp---#-p----P--------------------------------
P--------------------------------------------########-####--------------------------------B-###############################---B----------------------p---
P------------#-??------#---------------------########-####------??BBB---------------------B-###############################---B--------------P-------p---
P------------#-------#-------------------------------------------------------#---------------------------------------------------------------P-------p---
P-----------p#-------#-------------------------------------------------------#---------------------------------------------------------------P-------p---
P-----------p#------##------------------p------------------------------------##----------#----------------------------------###-#########--##############
######################---------------#--p-------------------------B?-??----####----------#------?---------------------------###-#########--##############
######################--------p---P-----p----------------------------------####--------------------------------------------------------------------------
------------------------------p---P-----p----------------------------------####-----#-------#------------------------------------------------------------
------------------------------p---P-----p----------------------------------####-----#-------#------------P-----------------------------------------------
p------------------------###########-#######-B?B----------################-##############-B--#------------P------------?P-----BB-------------------------
p-------------B----------###########-#######-------------#################-##############---##------------P--------p----P--------------------------------